"a" = (/turf/dirt,/area)
"b" = (/turf/grass,/area)
"c" = (/turf/dirt,/turf/terrain/grass_edges/e1,/area)
"d" = (/obj/terrain/pentagram,/turf/grass,/area)
"e" = (/turf/terrain/tree,/turf/grass,/area)
"f" = (/turf/terrain/hedge,/turf/grass,/area)
"g" = (/turf/grass,/turf/terrain/sidewalk,/area)

(1,1,1) = {"
aaaaaaaaaaaaaaaabbbbaabbbbbbbbbbbbbbbbbbbbbbbbbaaa
aaaaaaaaaaaaaaabbbbbaabbbbaaaabbbbbbbbbbbbbbbbbaaa
aaaaaaaaaabbbbbbbbbbbbbbbbaaaabbbbbbbbbbbbbbbbbbbb
aaaaaaaaaabbbbbbbbbbbbbbbbbbbbbbbbbbbbbbbbbbbbbbbb
aaabbbbbbbbbbbbbbbbbbbbbbbbbbbbbbbbbbbbbbbbbbbbbbb
abbbbbbbbbbbbbbbbbbbbbbbbbbbbbbbbbbbbbbbbbbbbbbbbb
abbbbbbbbbbbbbbbbbbbbbbbbbbbbbbbbbbbbbbbbbbbbbbbbb
abbbbbbbbbaaabbbbbbbbbbbbbbbbbbbbbbbbbbbbbbbbbbbbb
abbbbbbbbbaaabbbbbbbbbbbbbbbbbbbbbbbbbbbbbbbbbbbbb
abbbbbbbbbbaabbbbbbbbbbbbbbbbbbbbbbbbbbbbbbbbbbbbb
abbbbbbbbbbbbbbbbbbbbbbbbbbbbbbaabbbbbbbbbbbbbbbba
abbbbbbbbbbbbbbbbbbbbbbbbbbbbbbaabbbbbbbbbbbbbbbba
bbbbbbbbbbbbbbbbbbbbbbbbbbbbbbbbbbbbbbbbbbbbbbbbba
bbbbbbbbbbbbbbbbbbbbbbbbbbbbaaaabbaabbbbbbbbbbbbba
bbbbbbbbbbbbbbbbbbbbbbbbbbbbaaaabbaabbbbbbbbbbbaaa
bbbbbbbbbbbbbbbbbbbbbbbbbbbbbbbbbbbbbbbbbbbbbbbaaa
bbbbbbbbbbbbbbbbbbbbbbbbbbbbbbbbaaabbbbbbbbbbbbaaa
bbbbbbbaabbbbbbacccccccaaaaaaabbaaabbbbbbbbbbbbaaa
bbbbbbbaaaabbbbaaaaaaaaaaaaaaabbbbbbbbbbbbbbbbbaaa
bbbbbaaabaabaaaaaaaaaaaaaaaaaaaabbaabbbbbbbbbbaaaa
bbbbbaaabbbbaaaaaaaaaaaaaaaaaaaabbaabbbbbbbbbbaaaa
bbbbbbbbbbbbaaaaaaaaaaaaaaaaaaaaaaaaaabbbbbbbbaaaa
bbbbbbbbbbbbbbbaaaaaaaaaaaaaaaaaaaaaaabbbbbbbbaaaa
bbbbbbbbbbbbbbbaaaaaaaaaaaaaaaaaaaaaaaabbbbbbbaaaa
bbbbbbbaaabbbbbaaaaaaaaaaaaaaaaaaaaaaaabbbbbbbaaaa
bbbbbbbaaabbbbbbbaaaabbaaaaaaaaaaaaaaaabbbbbbbaaaa
bbbbbbbbbbbbbbbbbbbbbbbaaaaaaaaaaaaaaaabbbbbbbbbaa
bbbbbbbbbbbbbbbbbbbbbbbaaaaaaaaaaaaaaabbbbbbbbbbaa
bbbbbbbbbbbbbbbbbbbbbbbaaaaaaaaaaaaaaabbbbbbbbbbaa
abbbbbbbbbbbbbbbaabbbbbaaaaaaaaaaaaaaaabbbbbbbbbaa
abbbbbbbbbbbbbbbaabaaaabbbbbaaaabbbaaaabbbbbbbbbaa
abbbbbbbbbbbbbbbbbbaaaabbbbbbbbbbbbaaaabbbbbbbbbaa
abbbbdbbbbbbbbbbbbbaaaabbbbbbbbbbbbbbbbbbbbbbbbbaa
abbbbbbbbbbbbbbbbbbaaaabbbbbbbbbbbbbbbbbbbbbbbbbaa
abbbbbbbbbaaabbbbbbbbbbbbbbbbbbbbbbbbbbbbbbbbbbbaa
abbbbbbbaaaaabebbbbfbbbbbbbbbbbbbbbbbbbbbbbbbbbbbb
abbbbbbbaaabbbbbbbbbbbbbaaabbbbbbbbbbbbbbbbbbbbbbb
aabbbbbbaaabbbbbbbbbbbbbaaabbbbbbbbbbbbbbbbbbbbbbb
aabaabbbbbbbbbbbbbbbbbbbaaabbbbbbbbbbbbbbbbbbbbbbb
aabaabbbbbbbbbaabbbbbbbbbbbbbbbbbbbbbbbbbbbbbbbbbb
aabaabbbbbbbbbaabbbbbbbbbbbbbbbbbbbbbbbbbbbbbbaabb
aabbbbbbbbbbbbbbbbbbbbbbbbbbbbbbbbbbbaabbbbbbbaabb
bbbbbbbbbbbbbbaaabbbbbbbbbbbbbbbbbbbbaabbbbbbbaabb
bbbbbaabbbbbbbaaabbbbbbbbbbbbbbbbbbbbaabbbbbbbbbbb
bbbbbaabbgbgbgbgbgbaabbbbbbbbbbbbbbbbbbbbbbbbbbbbb
aaaaaaabbbbbbbbbbbbbbbbbbbbbbbbbbbbbbbbbbbbbbbbbbb
aaaaaaabbbbbbbbbbbbbbbbbbbbbbbbbbbbbbbbbbbbbbbbbbb
aaaaaaabbbbbbbbbbbbbbbbbbbbbbbbbbbbbbbbbbbbbbbbbbb
aaaaaaaaaaaaabbbbbbbbbbbbbbbbbbbbbbbbbbbbbbbbbbbbb
aaaaaaaaaaaaabbbbbbbbbbbbbbbbbbbbbbbbbbbbbbbbbbbbb
"}
