"aa" = (/obj/darkness,/turf/road,/area)
"ab" = (/turf/terrain/roadline,/obj/darkness,/turf/road,/area)
"ac" = (/turf/terrain/effects/cloud,/turf/terrain/roadline,/obj/darkness,/turf/road,/area)
"ad" = (/turf/terrain/cart,/obj/darkness,/turf/road,/area)
"ae" = (/turf/terrain/bottle,/obj/darkness,/turf/road,/area)
"af" = (/turf/terrain/newspaper,/obj/darkness,/turf/road,/area)
"ag" = (/obj/darkness,/turf/buildings/roof/r8,/area)
"ah" = (/turf/road,/obj/darkness,/turf/buildings/roof/r9,/area)
"ai" = (/turf/road,/obj/darkness,/turf/buildings/roof/r7,/area)
"aj" = (/obj/darkness,/turf/buildings/roof/r5,/area)
"ak" = (/obj/darkness,/turf/buildings/roof/r6,/area)
"al" = (/turf/terrain/sidewalk2,/turf/terrain/trashbag,/obj/darkness,/turf/grass,/area)
"am" = (/obj/darkness,/turf/grass,/area)
"an" = (/turf/terrain/sidewalk2,/turf/terrain/car2,/obj/darkness,/turf/grass,/area)
"ao" = (/turf/terrain/sidewalk2,/obj/darkness,/turf/grass,/area)
"ap" = (/obj/darkness,/turf/buildings/roof/r4,/area)
"aq" = (/turf/terrain/trashbag,/obj/darkness,/turf/grass,/area)
"ar" = (/turf/terrain/traffic_guard,/obj/darkness,/turf/grass,/area)
"as" = (/turf/terrain/effects/firefly,/obj/darkness,/turf/grass,/area)
"at" = (/obj/barricade/barrel,/obj/darkness,/turf/grass,/area)
"au" = (/turf/terrain/grass_edges/e7,/turf/terrain/effects/firefly,/obj/darkness,/turf/dirt,/area)
"av" = (/turf/terrain/grass_edges/e8,/turf/terrain/effects/firefly,/obj/darkness,/turf/dirt,/area)
"aw" = (/turf/terrain/grass_edges/e3,/obj/darkness,/turf/dirt,/area)
"ax" = (/turf/terrain/grass_edges/e2,/obj/item/gun/flamethrower,/obj/darkness,/turf/dirt,/area)
"ay" = (/turf/terrain/grass_edges/e5,/obj/darkness,/turf/dirt,/area)
"az" = (/turf/terrain/grass_edges/e6,/obj/darkness,/turf/dirt,/area)
"aA" = (/turf/terrain/effects/cloud,/obj/darkness,/turf/grass,/area)
"aB" = (/obj/hazard/fire,/obj/darkness,/turf/buildings/roof/r5,/area)
"aC" = (/turf/terrain/grass_edges/e7,/obj/darkness,/turf/road,/area)
"aD" = (/turf/terrain/grass_edges/e1,/obj/darkness,/turf/road,/area)
"aE" = (/turf/terrain/grass_edges/e8,/obj/darkness,/turf/road,/area)
"aF" = (/turf/terrain/grass_edges/e3,/obj/darkness,/turf/road,/area)
"aG" = (/turf/terrain/grass_edges/e2,/obj/darkness,/turf/road,/area)
"aH" = (/turf/terrain/grass_edges/e4,/obj/darkness,/turf/road,/area)
"aI" = (/turf/terrain/grass_edges/e6,/obj/darkness,/turf/road,/area)
"aJ" = (/turf/terrain/grass_edges/e3,/turf/terrain/blood,/obj/darkness,/turf/road,/area)
"aK" = (/turf/terrain/blood,/obj/darkness,/turf/grass,/area)
"aL" = (/turf/terrain/grass_edges/e5,/obj/darkness,/turf/road,/area)
"aM" = (/turf/buildings/roof/r5,/obj/darkness,/turf/buildings/roof/r11,/area)
"aN" = (/obj/darkness,/turf/buildings/roof/r2,/area)
"aO" = (/obj/darkness,/turf/buildings/roof/r3,/area)
"aP" = (/turf/terrain/chainlink,/obj/darkness,/turf/grass,/area)
"aQ" = (/obj/darkness,/turf/buildings/roof,/area)
"aR" = (/turf/buildings/roof/r5,/obj/darkness,/turf/buildings/roof/r10,/area)
"aS" = (/obj/darkness,/turf/buildings/b2,/area)
"aT" = (/obj/hazard/fire,/obj/darkness,/turf/buildings/b2,/area)
"aU" = (/obj/darkness,/turf/buildings/b7,/area)
"aV" = (/obj/markers/enemy_spawn,/obj/darkness,/turf/grass,/area)
"aW" = (/turf/terrain/grass_edges/e3,/obj/markers/enemy_spawn,/obj/darkness,/turf/road,/area)
"aX" = (/obj/markers/enemy_spawn,/obj/darkness,/turf/road,/area)
"aY" = (/turf/terrain/chainlink,/obj/darkness,/turf/road,/area)
"aZ" = (/turf/terrain/poster,/obj/darkness,/turf/buildings/b2,/area)
"ba" = (/turf/terrain/window,/obj/hazard/fire,/obj/darkness,/turf/buildings/b2,/area)
"bb" = (/turf/terrain/grass_edges/e7,/obj/markers/enemy_spawn,/obj/darkness,/turf/road,/area)
"bc" = (/turf/terrain/grass_edges/e1,/obj/markers/enemy_spawn,/obj/darkness,/turf/road,/area)
"bd" = (/turf/terrain/grass_edges/e2,/obj/markers/enemy_spawn,/obj/darkness,/turf/road,/area)
"be" = (/turf/terrain/window,/obj/darkness,/turf/buildings/b2,/area)
"bf" = (/obj/darkness,/turf/buildings,/area)
"bg" = (/turf/terrain/grass_edges/e7,/obj/markers/dense,/obj/darkness,/turf/road,/area)
"bh" = (/turf/terrain/grass_edges/e1,/obj/markers/dense,/obj/darkness,/turf/road,/area)
"bi" = (/turf/terrain/grass_edges/e1,/turf/terrain/trashbag,/obj/darkness,/turf/road,/area)
"bj" = (/turf/terrain/drain,/obj/darkness,/turf/road,/area)
"bk" = (/turf/terrain/grass_edges/e1,/turf/terrain/chainlink3,/turf/terrain/trashbag,/obj/darkness,/turf/road,/area)
"bl" = (/obj/barricade/barrel,/obj/darkness,/turf/road,/area)
"bm" = (/turf/terrain/hedge,/obj/darkness,/turf/grass,/area)
"bn" = (/obj/markers/dense,/obj/darkness,/turf/grass,/area)
"bo" = (/turf/terrain/grass_edges/e3,/turf/terrain/dumpster,/obj/markers/dense,/obj/darkness,/turf/road,/area)
"bp" = (/obj/markers/dense,/obj/darkness,/turf/road,/area)
"bq" = (/turf/terrain/blood,/obj/darkness,/turf/road,/area)
"br" = (/turf/terrain/chainlink3,/obj/darkness,/turf/road,/area)
"bs" = (/turf/terrain/grass_edges/e7,/obj/darkness,/turf/dirt,/area)
"bt" = (/turf/terrain/box,/obj/markers/dense,/obj/darkness,/turf/dirt,/area)
"bu" = (/obj/markers/dense,/obj/darkness,/turf/dirt,/area)
"bv" = (/turf/terrain/grass_edges/e3,/turf/terrain/trashbag,/obj/darkness,/turf/road,/area)
"bw" = (/obj/item/shield,/obj/darkness,/turf/road,/area)
"bx" = (/turf/terrain/effects/firefly,/obj/darkness,/obj/markers/player_spawn,/turf/road,/area)
"by" = (/obj/darkness,/obj/markers/player_spawn,/turf/road,/area)
"bz" = (/turf/terrain/blood,/obj/item/shield,/obj/darkness,/turf/road,/area)
"bA" = (/turf/terrain/grass_edges/e1,/obj/darkness,/turf/dirt,/area)
"bB" = (/turf/terrain/tree,/turf/terrain/effects/firefly,/turf/terrain/blood,/obj/darkness,/turf/dirt,/area)
"bC" = (/obj/markers/enemy_spawn,/obj/darkness,/turf/dirt,/area)
"bD" = (/turf/terrain/grass_edges/e6,/obj/markers/dense,/obj/darkness,/turf/dirt,/area)
"bE" = (/turf/terrain/effects/firefly,/obj/darkness,/turf/road,/area)
"bF" = (/turf/terrain/grass_edges/e4,/obj/darkness,/obj/item/gun/uzi,/turf/road,/area)
"bG" = (/turf/terrain/grass_edges/e4,/turf/terrain/sewer,/obj/darkness,/turf/road,/area)
"bH" = (/turf/terrain/grass_edges/e4,/obj/darkness,/turf/dirt,/area)
"bI" = (/turf/terrain/payphone,/obj/darkness,/turf/buildings,/area)
"bJ" = (/turf/terrain/grass_edges/e3,/turf/terrain/chainlink,/obj/darkness,/turf/road,/area)
"bK" = (/turf/terrain/effects/firefly,/obj/barricade/cone,/obj/darkness,/turf/road,/area)
"bL" = (/turf/terrain/grass_edges/e4,/obj/markers/enemy_spawn,/obj/darkness,/turf/road,/area)
"bM" = (/turf/terrain/grass_edges/e8,/obj/darkness,/turf/dirt,/area)
"bN" = (/turf/terrain/tombstone,/obj/darkness,/turf/grass,/area)
"bO" = (/turf/terrain/tree,/obj/darkness,/turf/grass,/area)
"bP" = (/turf/terrain/pentagram,/obj/item/shield,/obj/darkness,/turf/road,/area)
"bQ" = (/obj/darkness,/obj/item/gun/shotgun,/turf/road,/area)
"bR" = (/turf/terrain/effects/firefly,/obj/markers/enemy_spawn,/obj/darkness,/turf/grass,/area)
"bS" = (/turf/terrain/blood,/obj/markers/enemy_spawn,/obj/darkness,/turf/grass,/area)
"bT" = (/turf/terrain/grass_edges/e7,/obj/markers/enemy_spawn,/obj/darkness,/turf/dirt,/area)
"bU" = (/turf/terrain/grass_edges/e1,/obj/markers/enemy_spawn,/obj/darkness,/turf/dirt,/area)
"bV" = (/turf/terrain/tree,/turf/terrain/effects/firefly,/obj/darkness,/turf/grass,/area)
"bW" = (/turf/terrain/grass_edges/e5,/obj/markers/enemy_spawn,/obj/darkness,/turf/dirt,/area)
"bX" = (/turf/terrain/grass_edges/e4,/obj/markers/enemy_spawn,/obj/darkness,/turf/dirt,/area)
"bY" = (/turf/terrain/bottle,/obj/darkness,/turf/dirt,/area)
"bZ" = (/obj/darkness,/turf/dirt,/area)
"ca" = (/obj/darkness,/obj/markers/dense,/turf/grass,/area)
"cb" = (/turf/terrain/grass_edges/e1,/turf/terrain/blood,/obj/barricade/barrel,/obj/darkness,/turf/dirt,/area)
"cc" = (/turf/terrain/grass_edges/e1,/turf/terrain/effects/firefly,/obj/darkness,/turf/dirt,/area)
"cd" = (/turf/terrain/grass_edges/e5,/turf/terrain/bottle,/obj/markers/enemy_spawn,/obj/darkness,/turf/dirt,/area)
"ce" = (/turf/terrain/grass_edges/e4,/turf/terrain/bottle,/obj/darkness,/turf/dirt,/area)
"cf" = (/turf/terrain/grass_edges/e6,/turf/terrain/effects/firefly,/turf/terrain/bottle,/obj/darkness,/turf/dirt,/area)
"cg" = (/turf/terrain/grass_edges/e5,/turf/terrain/effects/firefly,/obj/barricade/barrel,/obj/darkness,/turf/dirt,/area)
"ch" = (/turf/terrain/grass_edges/e4,/turf/terrain/effects/firefly,/obj/darkness,/turf/dirt,/area)
"ci" = (/turf/terrain/grass_edges/e4,/obj/barricade/barrel,/obj/darkness,/turf/dirt,/area)
"cj" = (/turf/terrain/grass_edges/e6,/turf/terrain/blood,/obj/darkness,/turf/dirt,/area)
"ck" = (/turf/terrain/bottle,/obj/darkness,/turf/grass,/area)
"cl" = (/turf/terrain/blood,/turf/terrain/blood,/obj/darkness,/turf/grass,/area)
"cm" = (/turf/grass,/obj/darkness,/turf/buildings/roof/r9,/area)
"cn" = (/turf/grass,/obj/darkness,/turf/buildings/roof/r7,/area)
"co" = (/turf/terrain/bottle,/obj/markers/enemy_spawn,/obj/darkness,/turf/grass,/area)
"cp" = (/turf/terrain/billboard,/obj/darkness,/turf/buildings/roof/r5,/area)
"cq" = (/turf/terrain/effects/cloud,/obj/darkness,/turf/buildings/roof/r5,/area)
"cr" = (/obj/barricade/cone,/obj/darkness,/turf/grass,/area)
"cs" = (/turf/terrain/bottle,/obj/markers/dense,/obj/darkness,/turf/grass,/area)
"ct" = (/obj/barricade/cone,/obj/markers/dense,/obj/darkness,/turf/grass,/area)
"cu" = (/turf/terrain/effects/firefly,/turf/terrain/cart,/obj/markers/dense,/obj/darkness,/turf/grass,/area)
"cv" = (/turf/terrain/cart,/obj/markers/dense,/obj/darkness,/turf/grass,/area)
"cw" = (/turf/terrain/cart,/obj/darkness,/turf/grass,/area)

(1,1,1) = {"
aaaaaaaaaaaaaaaaaaaaaaaaaaaaaaaaaaaaaaaaaaaaaaaaaaaaaaaaaaaaaaaaaaaaaaaaaaaaaaaaaaaaaaaaaaaaaaaaaaaaaaaaaaaaaaaaaaaaaaaaaaaaaaaaaaaaaaaaaaaa
aaaaaaaaaaaaaaaaaaaaaaaaaaaaaaaaaaaaaaaaaaaaaaaaaaaaaaaaaaaaaaaaaaaaaaaaaaaaaaaaaaaaaaaaaaaaaaaaaaaaaaaaaaaaaaaaaaaaaaaaaaaaaaaaaaaaaaaaaaaa
aaaaaaaaaaaaaaaaaaaaaaaaaaaaaaaaaaaaaaaaaaaaaaaaaaaaaaaaaaaaaaaaaaaaaaaaaaaaaaaaaaaaaaaaaaaaaaaaaaaaaaaaaaaaaaaaaaaaaaaaaaaaaaaaaaaaaaaaaaaa
aaaaaaaaaaaaaaaaaaaaaaaaaaaaaaaaaaaaaaaaaaaaaaaaaaaaaaaaaaaaaaaaaaaaaaaaaaaaaaaaaaaaaaaaaaaaaaaaaaaaaaaaaaaaaaaaaaaaaaaaaaaaaaaaaaaaaaaaaaaa
aaaaaaaaaaaaaaaaaaaaaaaaaaaaaaaaaaaaaaaaaaaaaaaaaaaaaaaaaaaaaaaaaaaaaaaaaaaaaaaaaaaaaaaaaaaaaaaaaaaaaaaaaaaaaaaaaaaaaaaaaaaaaaaaaaaaaaaaaaaa
aaaaaaaaaaaaaaaaaaaaaaaaaaaaaaaaaaaaaaaaaaaaaaaaaaaaaaaaaaaaaaaaaaaaaaaaaaaaaaaaaaaaaaaaaaaaaaaaaaaaaaaaaaaaaaaaaaaaaaaaaaaaaaaaaaaaaaaaaaaa
aaaaaaaaaaaaaaaaaaaaaaaaaaaaaaaaaaaaaaaaaaaaaaaaaaaaaaaaaaaaaaaaaaaaaaaaaaaaaaaaaaaaaaaaaaaaaaaaaaaaaaaaaaaaaaaaaaaaaaaaaaaaaaaaaaaaaaaaaaaa
aaaaaaaaaaaaaaaaaaaaaaaaaaaaaaaaaaaaaaaaaaaaaaaaaaaaaaaaaaaaaaaaaaaaaaaaaaaaaaaaaaaaaaaaaaaaaaaaaaaaaaaaaaaaaaaaaaaaaaaaaaaaaaaaaaaaaaaaaaaa
aaaaaaaaaaababababababababababababababababababababababababababababababababababababababababababababacabababababababababababababababababababab
aaaaaaaaaaaaaaaaaaaaaaaaaaaaaaaaaaaaaaaaaaaaaaaaaaaaaaadaaaaaaaaaaaaaaaaaaaaaaaaaaaaaaaaaaaaaaaaaaaaaaaaaaaaaaaaaaaaaaaaaaaaaaaaaaaaaaaaaaaa
aaaaaaaaaaaaaaaaaaaaaaaaaaaaaaaaaaaaaaaaaaaaadaaaaaaaaaaaaaaaeaaaaaaaaaaaaaaaaaaaaaaaaaaaaaaaaaaaaaaaaaaaaaaaaaaaaaaaaaaaaaaaaaaaaaaaaaaaaaa
aaaaaaaaaaaaaaaaaaaaaaaaaaaaaaaaaaaaaaaaaaaaaaaaafaaaaaeaaaeaaaaaeaaaaaaaaaaaaaaaaaaaaaaaaaaaaaaaaaaaaaaaaaaaaaaaaaaaaaaaaaaaaaaaaaaaaaaaaaa
aaaaaaaaaaaaaaaaaaaaaaaaaaaaaaaaaaaaaaaaaaaaaaaaaaaaaaaaaeaeaaaeaaaaaaaaaaaaaaaaaaaaaaaaaaaaaaaaaaaaaaaaaaaaaaaaaaaaaaaaaaaaaaaaaaaaaaaaaaaa
agagagagagagagagagagagagagagagagagagagagagagagagagagagahaaaeaaaaaaaaaiagagagagagagagagagagagagagagagagagagagagagagagagagagagagagagagagagagag
ajajajajajajajajajajajajajajajajajajajajajajajajajajajakalamanamaoamapajajajajajajajajajajajajajajajajajajajajajajajajajajajajajajajajajajaj
ajajajajajajajajajajajajajajajajajajajajajajajajajajajakaqaqaramasatapajajajajajajajajajajajajajajajajajajajajajajajajajajajajajajajajajajaj
ajajajajajajajajajajajajajajajajajajajajajajajajajajajakaqamasasasasapajajajajajajajajajajajajajajajajajajajajajajajajajajajajajajajajajajaj
ajajajajajajajajajajajajajajajajajajajajajajajajajajajakamauavamasamapajajajajajajajajajajajajajajajajajajajajajajajajajajajajajajajajajajaj
ajajajajajajajajajajajajajajajajajajajajajajajajajajajakasawaxasamamapajajajajajajajajajajajajajajajajajajajajajajajajajajajajajajajajajajaj
ajajajajajajajajajajajajajajajajajajajajajajajajajajajakamayazamamamapajajajajajajajajajajajajajajajajajajajajajajajajajajajajajajajajajajaj
ajajajajajajajajajajajajajajajajajajajajajajajajajajajakatamamamamamapajajajajajajajajajajajajajajajajajajajajajajajajajajajajajajajajajajaj
ajajajajajajajajajajajajajajajajajajajajajajajajajajajakamaAamamamamapajajajajajajajajajajajajajajajajajajajajajajajajajajajajajajajajajajaj
ajajajajajajajajajajajajajajajajajajajajajajajajajajajakasamamasamamapajajajajajajajajajajajajajajajajajajajajajajajajajajajajajajajajajajaj
ajajajajajajajajajajajaBajajajajajajajajajajajajaBajajakasamaCaDaEamapajajajajajajajajajajajajajajajajajajajajajajajajajajajajajajajajajajaj
ajajajajajajajajajajajajajajajajajajajajajajajajajajajakamamaFaaaGamapajajajajajajajajajajajajajajajajajajajajajajajajajajajajajajajajajajaj
ajajajajajajajajajajajajajajajajajajajajajajajajajajajakamaCaaaHaIamapajajajajajajajajajajajajajajajajajajajajajajajajajajajajajajajajajajaj
ajajajajajajajajajajajajajajajajajajajajajajajajajajajakamaJaGamaKamapajajajajajajajajajajajajajajajajajajajajajajajajajajajajajajajajajajaj
ajajajajajajajajajajajajajajajajajajajajajajajajajajajakamaLaIamamamapajajajajajajajajajajajajajajajajajajajajajajajajajajajajajajajajajajaj
ajajajajajajajajajajajajajaBajajajajajajajajajajajajajakamaKamaKaKamapajajajajajajajajajajajajajajajajajajajajajajajajajajajajajajajajajajaj
ajajajajajajajajajajajajajajajajajajajajajajajajajajajakamamaKamaCaEapajajajajajajajajajajajajajajajajajajajajajajajajajajajajajajajajajajaj
ajajajajajajajajajajajajajajajajajajajajajajajajajajajakamamamaKaFaGapajajajajajajajajajajajajajajajajajajajajajajajajajajajajajajajajajajaj
ajajajajajajajajajajajajajajaMaNaNaNaNaNaNaNaNaNaNaNaNaOaPamaCaDaaaGaQaNaNaNaNaNaNaNaNaNaNaRajajajajajajajajajajajajajajajajajajajajajajajaj
ajajajajajajajajajajajajajajakaSaSaSaSaTaSaSaSaSaSaSaSaUaVaVaWaXaYaGaSaSaSaSaSaSaSaTaSaSaSapajajajajajajajajajajajajajajajajajajajajajajajaj
ajajajajajajaBajajajajajajajakaZaSaSbaaTaSaSaSbaaTaSaSaUbbbcaXaXaXbdaSbeaTaSaSaSbaaSaSaSaSapajajajajajajajajajajajajajajajajajajajajajajajaj
ajajajajajajajajajajajajajajakaSaZaSaTaTaSaSaSaSaTaSaSaUaFaaaaaaaXbdaSaTaTaSaSaSaTaSaSaSaSapajajajajajajajajajajajajajajajajajajajajajajajaj
ajajajajajajajajajajajajajajakaSaSaSbeaTaSaSaSbaaTaSaSaUaFaaaaaaaHaIaSbaaSaSaSaSbaaTaSaSaSapajajajajajajajajajajajajajajajajajajajajajajajaj
ajajajajajajajajajajajajajajakbfbfbfbfbfbfbfbfbfbfbfbfbfaFaaaaaGamambfbfbfbfbfbfbfbfbfbfbfaQaNaNaNaNaNaNaNaNaNaNaNaNaNaNaNaNaNaNaNaNaNaNaNaN
aNaNaNaNaNaNaNaNaNaNaNaNaNaNaObgbhbhbibibiaDbjaaaDaDbibkblaaaaaGamamambmambmambmambnbnamamaSaSaTaSaSaSaSaSaSaSaSaSaTaSaSaSaSaSaSaSaSaSaSaSaS
aSaSaSaSaSaTaTaSaSaSaSaSaSaSaUbobpbpaaaaaaaaaaaabqaaaabraaaaaaaGamamamamamamamambsbtbuamamaSaSbeaTaSaSaSbeaTaSaSaSbaaSaSaSaSbaaTaSaSaSaSaSaS
aSaSaSaSaSbeaTaSaSaSbaaSaTaSaUbvbwaaaabxbyaaaabzbqaabqaaaaaaaaaaaDaDaDaEamambsbAbBbCbDbnamaSaSaSaTaSaSaSaSaTaSaSaSaSaTaSaSaSaSaSaSaSaSaSaSaS
aSaSaSaSaSaTaSaSaZaSaSaSaSaSaUaFaabEbyaaaabyaabqaabqaaaaaaaabFaHaHbGaaaGamamaybHbHazatamamaSaSbaaSaSaSaSbaaSaSaSaSbeaTaSaSaSbeaSaSaSaSaSaSaS
aSaSaSaSaSbeaTaSaSaSbaaTaSaSaUbvaaaaaabybyaabEaaaaaaaaaaaaaGamamamamaLaIamasamamamamamamambIbfbfbfbfbIbfbfbfbfbIbfbfbfbfbfbfbfbfbfbfbfbfbfbf
bfbfbfbfbfbfbfbfbfbfbfbfbfbfbfbJaabKaaaabEaaaaaYaaaYaaaabLaIamaCaEamamamamamaAbsbMamamamamamaCaDaDaDaDaDaDaDaDaEaVaVbNbOaVbnbnambOambnbnamam
amamamaVaVaVamamambmambmamatataFaabPaaaaaaaabwaaaaaabQaGamamamaLaIamamamamamamayazamamasamamaFaaafaaaaaaaaaaaaaGaVbRbSasambOaVbnbnamamamamam
amamambTbUbUbAbMamaVamamamamamaFaHaHaHaHaaaaaaaaaHaHaHaIamamamamamamamaCaDaDaEamamamaCaDaDaDaaaaaaaaaaaHaHaHaHaIaKamaKamambVaVbnbnamamamamam
amamambWbXbCbYbZbAbMamamaCaDaDaGasamamamaFaaaaaGambOamcacaaCaEamamamamaLaHaHaIamamamaLaHaHaHaHaHaHaHaIamamamamamaKamaucbccbMbOaVbnbnamamamam
amamamaVaVcdbHbHcecfamamaLaHaHaIamamamamaLaHaHaIamamamamamaLaIamamamamamamamamamamamamamamamamamamamamamamamamamamamcgchcicjbOaVbnbnamamamam
amamamaVaVaVamamckckckamamamaAamamamamamamamamamclamamamamamamamamamamamamamamamamamamamamamamamamamamamasasamamamamamaKambOaVbnbnamamamamam
agagagagagagagagagagagagagagagagagagagagcmaKamaKasamamcnagagagagagagagagagagagagagagagagagagagagagagagagagagagagagagagagagagagagagagagagagag
ajajajajajajajajajajajajajajajajajajajajakamamamamamamapajajajajajajajajajajajajajajajajajajajajajajajajajajajajajajajajajajajajajajajajajaj
ajajajajajaBajajajajajajajajajajajajajajakaVaVaVbSaVaVapajajajajajajajaBajajaBajajajajajajajajajajajajajajajajajajajajajajajajajajajajajajaj
ajajajajajajajajajajajajajajajajajajajajakaVbRaVaVaVcoapajajajajajajajcpajajajajajajajajajajajajajajajajajajajajcqajajajajajajajajajajajajaj
ajajajajajajajajajajajajajajajajajajajajakatbSckcrcramapajajajajajajaBajajajajajajajajajajajajajajajajajajajajajajajajajajajajajajajajajajaj
ajajajajajajajajajajajajaBajajajajajajajakcsctbnbncubnapajajajajajajajajajajajajajajajajajajajajajajajajajajajajajajajajajajajajajajajajajaj
ajajajajajajajajajajajajajajajajajajajajakcscvbnbnbnbnapajajajajajajajajajajajajajajajajajajajajajajajajajajajajajajajajajajajajajajajajajaj
ajajajajajajajajajajajajajajajajajajajajakamamcrcwamamapajajajajajajajajajajajajajajajajajajajajajajajajajajajajajajajajajajajajajajajajajaj
ajajajajajajajajajajajajajajajajajajajajakcwamamamamamapajajajajajajajajajajajajajajajajajajajaBajajajajajajajajajajajajajajajajajajajajajaj
ajajajajajajajajajaBaBajajajajajajajajajakamamaAamamamapajajajajajajajajajajajajajajajajajajajajajajajajajajajajajajajajajajajajajajajajajaj
ajajajajajajajajajaBajajajajajajajajajajakamamamamamamapajajajajajajajajajajajajajajajajajajajajajajajajajajajajajajajajajajajajajajajajajaj
ajajajajajajajajajajajajajajajajajajajajakamamamamamamapajajajajajajajajajajaBajajajajajajajajajajajajajajajajajajajajajajajajajajajajajajaj
ajajajajajajajajajajajajajajajajajajajajakamamamamamamapajajajajajajajajajajajajajajajajajajajajajajajajajajajajajajajajajajajajajajajajajaj
ajajajajajajajajajajajajajajajajajajajajakamamamamamamapajajajajajajajajajajajajajajajajajajajajajajajajajajajajajajajajajajajajajajajajajaj
ajajajajajajajajajajajajajajajajajajajajakamamamamamamapajajajajajajajajajajajajajajajajajajajajajajajajajajajajajajajajajajajajajajajajajaj
"}
