"aa" = (/turf/buildings/roof/r5,/area)
"ab" = (/turf/buildings/roof/r6,/area)
"ac" = (/turf/road,/area)
"ad" = (/turf/terrain/roadlineB,/turf/road,/area)
"ae" = (/turf/buildings/roof/r5,/turf/buildings/roof/r11,/area)
"af" = (/turf/buildings/roof/r2,/area)
"ag" = (/turf/buildings/roof/r5,/turf/buildings/roof/r10,/area)
"ah" = (/turf/buildings/b6,/area)
"ai" = (/turf/buildings/b2,/area)
"aj" = (/turf/buildings/roof,/area)
"ak" = (/turf/buildings/roof/r3,/area)
"al" = (/turf/buildings/b7,/area)
"am" = (/turf/buildings/roof/r4,/area)
"an" = (/turf/terrain/cart,/turf/road,/area)
"ao" = (/turf/terrain/window,/turf/buildings/b2,/area)
"ap" = (/turf/terrain/car,/turf/road,/area)
"aq" = (/turf/terrain/poster,/turf/buildings/b2,/area)
"ar" = (/obj/hazard/fire,/turf/road,/area)
"as" = (/turf/terrain/poster,/turf/buildings/b6,/area)
"at" = (/turf/terrain/roadlineB,/obj/hazard/fire,/turf/road,/area)
"au" = (/turf/buildings,/area)
"av" = (/turf/terrain/car2,/turf/road,/area)
"aw" = (/obj/markers/dense,/turf/road,/area)
"ax" = (/turf/road,/obj/markers/dense,/turf/buildings/b3,/area)
"ay" = (/turf/road,/turf/terrain/door,/obj/markers/dense,/turf/buildings/b4,/area)
"az" = (/turf/road,/obj/markers/dense,/turf/buildings/b4,/area)
"aA" = (/turf/road,/turf/terrain/loading_door,/obj/markers/dense,/turf/buildings/b4,/area)
"aB" = (/turf/road,/obj/markers/dense,/turf/buildings/b5,/area)
"aC" = (/obj/barricade/barrel,/turf/road,/area)
"aD" = (/turf/terrain/dumpster,/obj/markers/dense,/turf/road,/area)
"aE" = (/obj/markers/dense,/obj/markers/dense,/turf/road,/area)
"aF" = (/turf/terrain/effects/firefly,/turf/road,/area)
"aG" = (/turf/terrain/effects/cloud,/turf/road,/area)
"aH" = (/obj/item/special/molotov,/turf/road,/area)
"aI" = (/turf/terrain/trashbag,/turf/road,/area)
"aJ" = (/turf/terrain/roadlineB,/turf/terrain/car,/obj/markers/dense,/turf/road,/area)
"aK" = (/turf/terrain/window,/turf/buildings/b6,/area)
"aL" = (/turf/terrain/car2,/obj/markers/dense,/turf/road,/area)
"aM" = (/turf/terrain/cart,/obj/markers/dense,/turf/road,/area)
"aN" = (/turf/terrain/roadlineB,/turf/terrain/trashbag,/obj/markers/dense,/turf/road,/area)
"aO" = (/obj/item/gun/crossbow,/turf/road,/area)
"aP" = (/obj/barricade/cone,/turf/road,/area)
"aQ" = (/turf/terrain/blood,/turf/road,/area)
"aR" = (/turf/terrain/blood,/obj/item/special/glowstick_r,/turf/road,/area)
"aS" = (/turf/terrain/sewer,/turf/road,/area)
"aT" = (/turf/terrain/blood,/obj/hazard/fire,/turf/road,/area)
"aU" = (/turf/terrain/pentagram,/turf/road,/area)
"aV" = (/turf/terrain/chainlink,/turf/road,/area)
"aW" = (/obj/markers/enemy_spawn,/turf/grass,/area)
"aX" = (/turf/grass,/area)
"aY" = (/obj/barricade/barrel,/turf/grass,/area)
"aZ" = (/obj/barricade/cone,/turf/grass,/area)
"ba" = (/obj/item/special/glowstick_b,/turf/grass,/area)
"bb" = (/obj/markers/enemy_spawn,/turf/road,/area)
"bc" = (/turf/terrain/sidewalk,/obj/markers/enemy_spawn,/turf/road,/area)
"bd" = (/turf/terrain/sidewalk,/turf/road,/area)
"be" = (/turf/terrain/crosswalk,/turf/road,/area)
"bf" = (/turf/terrain/crosswalk,/turf/terrain/blood,/turf/road,/area)
"bg" = (/turf/terrain/drain,/turf/road,/area)
"bh" = (/turf/terrain/crosswalk/c2,/turf/road,/area)
"bi" = (/turf/terrain/car,/obj/markers/dense,/turf/road,/area)
"bj" = (/obj/item/special/firewall,/turf/road,/area)
"bk" = (/obj/item/revive_pack,/turf/road,/area)
"bl" = (/obj/item/gun/revolver,/turf/road,/area)
"bm" = (/obj/item/gun/LB01,/turf/road,/area)
"bn" = (/turf/terrain/roadline,/obj/markers/enemy_spawn,/turf/road,/area)
"bo" = (/turf/terrain/roadline,/turf/road,/area)
"bp" = (/turf/terrain/effects/firefly,/turf/terrain/blood,/turf/road,/area)
"bq" = (/turf/terrain/helipad,/turf/road,/area)
"br" = (/turf/terrain/sidewalk2,/obj/markers/enemy_spawn,/turf/grass,/area)
"bs" = (/turf/terrain/sidewalk2,/turf/grass,/area)
"bt" = (/turf/terrain/sidewalk2,/obj/barricade/barrel,/turf/grass,/area)
"bu" = (/turf/terrain/blood,/turf/grass,/area)
"bv" = (/turf/terrain/sidewalk2,/obj/barricade/crate,/turf/grass,/area)
"bw" = (/obj/barricade/crate,/turf/grass,/area)
"bx" = (/turf/terrain/sidewalk2,/turf/terrain/car2,/obj/markers/dense,/turf/grass,/area)
"by" = (/obj/markers/dense,/turf/grass,/area)
"bz" = (/turf/terrain/sidewalk2,/obj/markers/dense,/turf/grass,/area)
"bA" = (/turf/terrain/guardrail/r4,/turf/grass,/area)
"bB" = (/turf/terrain/guardrail/r5,/turf/grass,/area)
"bC" = (/turf/terrain/guardrail/r6,/turf/grass,/area)
"bD" = (/turf/terrain/pond/p8,/turf/grass,/area)
"bE" = (/turf/terrain/pond/p9,/turf/grass,/area)
"bF" = (/turf/terrain/hedge,/turf/grass,/area)
"bG" = (/turf/terrain/trashbag,/turf/grass,/area)
"bH" = (/turf/terrain/pond/p7,/turf/grass,/area)
"bI" = (/turf/terrain/pond/p5,/turf/grass,/area)
"bJ" = (/turf/terrain/pond/p6,/turf/grass,/area)
"bK" = (/turf/terrain/tree,/obj/barricade/barrel,/turf/grass,/area)
"bL" = (/turf/terrain/tombstone,/turf/grass,/area)
"bM" = (/turf/terrain/pond/p4,/turf/grass,/area)
"bN" = (/turf/terrain/effects/firefly,/turf/grass,/area)
"bO" = (/turf/terrain/grass_edges/e7,/turf/dirt,/area)
"bP" = (/turf/terrain/grass_edges/e8,/obj/markers/enemy_spawn,/turf/dirt,/area)
"bQ" = (/turf/terrain/effects/cloud,/turf/grass,/area)
"bR" = (/turf/terrain/grass_edges/e3,/turf/dirt,/area)
"bS" = (/turf/terrain/grass_edges/e2,/turf/dirt,/area)
"bT" = (/turf/terrain/tree,/turf/grass,/area)
"bU" = (/turf/terrain/grass_edges/e1,/turf/dirt,/area)
"bV" = (/turf/dirt,/area)
"bW" = (/turf/terrain/grass_edges/e6,/turf/dirt,/area)
"bX" = (/turf/terrain/pond/p5,/turf/terrain/pond/p11,/turf/grass,/area)
"bY" = (/turf/terrain/pond/p2,/turf/grass,/area)
"bZ" = (/turf/terrain/pond/p3,/turf/grass,/area)
"ca" = (/turf/terrain/grass_edges/e8,/turf/dirt,/area)
"cb" = (/turf/terrain/grass_edges/e2,/turf/terrain/effects/firefly,/turf/dirt,/area)
"cc" = (/turf/terrain/grass_edges/e5,/turf/dirt,/area)
"cd" = (/turf/terrain/grass_edges/e4,/turf/dirt,/area)
"ce" = (/turf/terrain/pond/p5,/turf/terrain/pond/p12,/turf/grass,/area)
"cf" = (/turf/terrain/pond/p6,/turf/terrain/obelisk,/turf/grass,/area)
"cg" = (/turf/terrain/trashbag,/obj/markers/dense,/turf/grass,/area)
"ch" = (/obj/item/revive_pack,/turf/grass,/area)
"ci" = (/turf/terrain/obelisk,/turf/grass,/area)
"cj" = (/turf/terrain/pond/p5,/turf/terrain/tree,/turf/grass,/area)
"ck" = (/turf/terrain/grass_edges/e1,/obj/item/special/glowstick_g,/turf/dirt,/area)
"cl" = (/obj/barricade/crate,/turf/dirt,/area)
"cm" = (/obj/markers/player_spawn,/turf/dirt,/area)
"cn" = (/turf/terrain/pond/p5,/turf/terrain/pond/p13,/turf/grass,/area)
"co" = (/turf/terrain/grass_edges/e3,/obj/barricade/crate,/turf/dirt,/area)
"cp" = (/turf/terrain/grass_edges/e3,/turf/terrain/effects/firefly,/turf/dirt,/area)
"cq" = (/turf/terrain/effects/cloud,/turf/dirt,/area)
"cr" = (/turf/terrain/effects/firefly,/turf/dirt,/area)
"cs" = (/turf/terrain/grass_edges/e3,/obj/markers/player_spawn,/turf/dirt,/area)
"ct" = (/turf/terrain/pond/p5,/turf/terrain/pond/p5,/turf/grass,/area)
"cu" = (/turf/terrain/grass_edges/e4,/obj/markers/player_spawn,/turf/dirt,/area)
"cv" = (/turf/terrain/pond,/turf/grass,/area)
"cw" = (/turf/terrain/pond/p5,/turf/terrain/pond/p10,/turf/grass,/area)
"cx" = (/turf/terrain/gothic_fence,/turf/grass,/area)

(1,1,1) = {"
aaaaaaaaaaaaaaaaaaaaaaaaaaaaaaaaaaaaaaaaaaaaaaaaaaaaaaaaaaaaaaaaaaaaaaaaaaaaaaaaaaaaaaaaaaaaaaaaaaabacacacacacacadacacac
aaaaaaaaaaaaaaaaaaaaaaaaaaaaaaaaaaaaaeafafafafafafafafagaaaaaaaaaaaaaaaeafafafafagaaaaaaaaaaaaaaaaabacacacacacacadacacac
aaaaaaaaaaaaaaaaaaaaaaaaaaaaaaaaaaaaabahaiaiaiaiaiaiaiajafafafafafafafakaiaiaialamaaaaaaaaaaaaaaaaabacacacacacanadacacac
aaaaaaaaaaaaaaaaaaaaaaaaaaaaaaaaaaaaabahaiaoaiaiaiaiaiahaiaiaiaiaiaiaialaoaiaialamaaaaaaaaaaaaaaaaabapacacacacacadacanac
aaaaaaaaaaaaaaaaaaaaaaaaaaaaaaaeafafakahaiaiaiaiaiaiaiahaiaiaiaiaiaiaqalaiaiaialamaaaaaaaaaaaaaaaaabacacacanacaradacanac
aaaaaaaaaaaaaaaaaaaaaaaaaaaaaaabahaialasaiaiaiaiaiaiaiahaqaiaiaiaiaiaialaiaiaialamaaaaaaaaaaaaaaaaabacanacacacacadanacac
aaaaaaaaaaaaaaaaaaaaaaaaaaaaaaabahaialahaiaoaiaiaiaiaiahaiaiaiaiaiaiaialaoaiaialamaaaaaaaaaaaaaaaaabacacaracanacatacanac
aaaaaaaaaaaaaaaaaaaaaaaaaaaaaaabahaialahaiaiaiaiaiaiaiahaiaiaiaiaiaiaialaiaiaialamaaaaaaaaaaaaaaaaabacanacaracacadacacac
aaaaaaaaaaaaaaaaaaaaaaaaaaaaaaabahaqalauauauauauauauauahaiaiaiaiaiaiaialauauauauamaaaaaaaaaaaaaaaaabaracacacacavadacarac
afafafafafafafafafafafafafafafakasaialacacawawacacacacaxayazazaAazazazaBacacaCaCajafafafafafafafafakaracapacacacadacacac
ahaiaiaiaiaiaiaiaiaiaiaiaiaiaialahaialaDawaEawacacacacacaFacacacaGaFacacacaCacaHahaiaiaiaiaiaiaiaialacacacacaIaIaJawawaw
aKaiaiaiaiaoaiaiaiaiaoaiaiaiaialauauauacacacacacacacacacacacacacacacacacacacacaCahaoaiaiaiaiaoaiaialaLawawawaMawaNaOaIac
ahaiaiaiaiaiaiaiaiaiaiaiaiaiaialaCaCacaPacacacacaFacacaQaRacacacacacacacaSacacacahaiaiaiaqaiaiaiaialaIaIaIaIacaCadaracac
ahaiaiaiaiaiaiaiaiaiaiaiaiaiaqalacacaPacacacacacacacacaQaQaQacaQaQacacacacacacacahaiaiaiaiaqaiaiaialacaIaCaCacaTadanacac
aKaiaiaiaiaoaiaiaiaiaoaiaiaqaialaPacacacacacacacacacacacacacacacaQaQacacacacacacahaoaiaiaiaiaoaiaialaIacaFacaQaQadacaPac
ahaiaiaqaiaiaiaiaiaiaiaiaiaiaialacacaFacacacacaCacacaUacacaFacacacacacacacacacacahaiaiaiaiaiaiaiaialaPacaQacaPaQadaPacac
auauauauauauauauauauauauauauauauacacacacacacaVacaVacaVacaVacaVacaVacacacacaFacacauauauauauauauauauauaracaPaQaQacaPacacac
aWaXaXaXaXaXaXaXaYaXaXaXaXaXaXaXacacacacacacaXaXaXaZaXaXaYaXaYaYaXaXaPacacacacacaXaXaXaXbaaXaXaXaXaXacacacaQacacaFacacbb
bcacbdacbdacbdacbdacbdaGbdacbdacbeacbeacbeacbdacbdacbdacbdaCbdacbdaPbeacbeacbeacbdacbdacbdacbdacbdacbeacbeaQbfaQbfacbebb
bbacbgawawawawacacacacacacacacacacacacacacacacacacacaPacbgacacaPacacacacacacacacacacacacacacbgacbhacacacacacacacacacacbb
bbacacbiawawawacaQacacacacacacacacaFacacacacacacacacacacaPaPacacacacacacacacacacacacacacacacacacacacacaQacacacacaQacaFbb
bbacacacacacacaQaQacacacacacacacaHacacacbjacbkacacacacacacacacacacacaQacacacacacacacacacacacacacbhacacacacacacacacacacbb
bbacacacacaQaQaQacacacacacacacacacblacacacacacacacacbmacacacacacacacacacacacacacacacacacacacacacacacacacacacacacacacacbb
bnboboboboboboboboboboboboboboboboboboboboboboboboboboboboboboboboboboboboboboboboboboboboboboacbhacacacacbpacacacacacbb
bbacacacacacacacacacacacacacacacacacacacacacacacacacacacacacacacacacacacacacacacacacacacacacacacacacacacacacaQacacacacbb
bbacacacacaQacaFacacacacacacacacacacacacacacacacacacacacacacacacacacacacacacacacacacacacacacacacbhacacacacacacacaFacacbb
bbacacaQacacacacacacaSacacacacacacacacacaQaQacacaFacacacacacacacacacacacacacacacacacacacacacacacacacacacbqacacacacacacbb
bbacacacacacacacacacacacacacacacaQacacacacacacaQacacacacacacacacacacacacacacacacacacacacacacacacbhacacacacacacacacacacbb
bbacacacacacacacacacacacacacacacacacacacacaQacacacacacacacacacacacacacacacacacacacacacacacacawawawawacacacacacacacacacbb
braXbsaXbsaXbsaXbsaXbsaXbsaXbsaXbsaYbtbubsaXbsaXbvaXbsaXbsaXbsaXbsaYbsaXbsaXbsbwbsaXbsaXbsaXbxbybzbybsaXbsaXbsaXbsaXbsaW
bAbAbAbAbAbAbAbAbAbAbAbAbAbAbAbAbAbAbAbAbAbBbwaXaXaXbwaXbCbAbAbAbAbAbBbwaXaXaXaXaXbwbwaXbCbAbAbAbAbAbAbAbAbAbAbAbAbAbAbA
bDbDbDbDbDbDbDbDbDbDbDbDbEbFaXbFaXbFaXbFaXaXaXaXaXaXaXaXbGbFaXbFaXbFaXaXaXaXaXaXaXaXaXbwaXaXbFaXbFaXbFaXbFaXbFaXbHbDbDbD
bIbIbIbIbIbIbIbIbIbIbIbIbJbKaXbybyaXbLaXaXaXaXaXaXaXaXaXaXaXaXaXaXaXaXaXaXaXaXaXaXaXaXaXaXaXaXaXaXaXaXaXaXaXaXbGbMbIbIbI
bIbIbIbIbIbIbIbIbIbIbIbIbJaXbLaYaXaXaXaXaXbNaXaXaXaXaXaXaXaXaXaXaXaXaXaXaXaXaXaXaXaXaXaXaXaXaXaXaXbLaXaXaXaXaXaXbMbIbIbI
bIbIbIbIbIbIbIbIbIbIbIbIbJaXaXaXaXaXaZaXaXaXaXaXaXaXaXaXaXaXaXbObPaXaXbNaXaXaXbLbFaXbFaXbLaXaXaXaXaWaXaXaXaXaXaYbMbIbIbI
bIbIbIbIbIbIbIbIbIbIbIbIbJaXaZaXaXaXaXaXaXbQaXaXaXaXaXaXaYbFaXbRbSaXaXaXaXaXaXaWaXaXaYaXaWaXaXaXaXaXbTaXaXaXbFaXbMbIbIbI
bIbIbIbIbIbIbIbIbIbIbIbIbJaXaXaXaXaXaXaXaXaXaXaXaXaXaXaXbObUbUbVbWaXaXaXaXaXaXaXaXaXaXaXaXaXaXaXaXaXaXaXaXaYaXaXbMbIbIbI
bIbIbIbIbIbIbXbYbYbYbYbYbZbLbFaXbFaXbLbFaXaXaXbObUbUcaaXbRbVbVbSaXaXaXaXaXaXaXaXaXaXaXaXaXaXaXaXaXaXaXaXaXaXaXaXbMbIbIbI
bIbIbIbIbIbIbJbybybybybFaXaXaXaXaXaXaXaXaXaXaXbRbVbVcbaXcccdcdbWaXbLaXaXaXaXaXaXaXaXaXbLaXaXaXaXaXaXaXaXaXaXbHbDcebIbIbI
bIbIbIbIbIbIcfbybybycgaXaXaXaXaXaXaXaXaXaXaXaXbRbVbVbSaXaXaXaXaXaXaWaXaXaXaXaXaXaXaXaXaWaXaXbNaXbLaXaXaXaXaXbMbIbIbIbIbI
bIbIbIbIbIbIbJbGaXaXaXaXaXaXaXaXaXaXaXaXaXaXaXcccdbVbVcaaXaXaXaXbNaXaXaXaXaXbLaXaXaXaXaXaXaXaXaXaWaXaXaXaXaXbMbIbIbIbIbI
bIbIbIbIbIbIbJaXaXaXbNaXaXaXaXbLaXaXaXaXaXaXaXaXaXbRbVbSaXaXaXaXaXaXaXaXaXaXaWaXaXaXaXaXbLaXaXaXbTaXbybyaXaXbMbIbIbIbIbI
bIbIbIbIbIbIbJaXaXaXaXaXaXaXaXaWaXaXaXbLaXaXaXaXaXbRbVbWaXaXaXaXaXbLaXaXaXaXaXaXaXaXaXaXaWaXaXaXaXaXbTbGbybybMbIbIbIbIbI
bIbIbIbIbIbIbJaXaXaXaXaXaXaXaXaXaXaXaXaWaXaXaXaXaXbRbSbFaXaXaXaXaXaWaXaXaXaXaXbLbGaXaXaXaXaXaXaXaXaXaXaXaXbGbMbIbIbIbIbI
bIbIbIbIbIbXbZchaXaXaXaXaXaXaXaXaXaXaXbOcaaXaXaXaXccbVcaaXaXaXaXaXaXbOcaaXaXaXaWaXaXaXaXaXaXaXaXaXaXcgbybybybMbIbIbIbIbI
bIbIbIbIbIbJbFaXaXaXaXaXaXaXbLaXaXaXaXccbWaXaXaXaXaXbRbSaXaXaXaXaXaXccbWaXaXaXaXaXaXbLaXaXaXaXaXbFcibybybybybMbIbIbIbIbI
bIbIbIbIcjbJbybybybybyaXaXaXaWaXaXaXaXaXaXaXaXaXaXbObVbSaXaXbTchbybyaXaXaXbLaXaXaXaXaXbwaXaXaXaXbHbDbDbDbDbDcebIbIbIbIbI
bIbIbIbIbIbJcibybybybyaXaXaXaXbOckcaaXaXbLaXaXaXaXbRbVbVbUcabFaXbLaXaXaXaXaWaXaXaXaXbNaXaXbwaXaXbMbIbIbIbIbIbIbIbIbIbIbI
bIbIbIbIbIbJaXbFaXaYaXaXaXaXaXbRbVbVcaaXaWaXaXaXbOclbVcmbVbVbUcaaWaXaXaXaXaXaXaXaXaXaXaXbwaXaXaXbMbIbIbIbIbIbIbIbIbIbIbI
bIbIbIbIbIcnbDbDbEaXaXaXbGbLaXbRbVbVbSbFaXbFaXaXcoclclbVbVbVbVbSaXaXaXaXaXaXaXaXbNaXaXaXaXaXbwaXbMbIbIbIbIbIbIbIbIbIbIbI
bIbIbIbIbIbIbIbIbJaXaXaXaXbGaXcpbVbVbSbLaXaXaXbObVclbVbVcqcrcmbSaXaXaXbObUcaaXaXaXaXaXaXaXbwaXaXbMbIbIbIbIbIbIbIbIbIbIbI
bIbIbIbIbIbIbIbIbJaXaXaXaXaXaXcccdbVbVbPaXaXaXcsbVbVcmbVbVbVbVbWaXaXaXbRbVbSaXaXaXaXbLaXaXaXaXaXbMbIbIbIbIbIbIbIbIbIbIbI
bIbIbIbIbIbIbIbXbZaXaXaXaXaXaXaXaXbRbVbSaXaXaXbRbVbVbVcmbVbVbSaXaXaXaXbRbVbSaXbLaXaXaWaXaXaXaXaXbMbIbIbIbIbIbIbIbIbIbIbI
bIbIbIbIbIctbIbJaYaXaXaXaXaXbLaXaXcccdbWaXaXbNcpbVbVbVbVbVcmbSaXaXbLaXcccdbWaXaWaXaXaXaXaXaXaXaXbMbIbIbIbIbIbIbIbIbIbIbI
bIbIbIbIbIbIbIbJaXaXaXbNaXaXaWaXaXaXaXaXaXaXaXcccdcubVbVbVcdbWaXaXaWaXaXaXaXaXaXaXaXaXaXaXaXaXaXcvbYbYcwbIbIbIbIbIbIbIbI
bIbIbIbIbIbIbIbJaXaXaXaXaXaXaXaXaXaXaXaXaXaXaXaXaXaXbRbVbSaXaXaXaXbOcaaXaXaXaXaXbNaXaXaXaXaXaXaXaYbFaXbMbIbIbIbIbIbIbIbI
bIbIbIbIbIbIbIbJbGaXaXaXaXaXaXaXaXaXbGbLaXaXaXaXaXaXcccubWaXaXaXaXccbWaXaXaXaXaXaXaXaXbLaXaXaXaXaXaXaXbMbIbIbIbIbIbIbIbI
bYbYbYbYbYbYbYbZbFaXbGaXaXbLaXaXaXaXaXaXaXaXaXaXaXaXaXaXaXaXaXbLaXaXaXaXaXaXbLaXaXaXaXaXaXaXaXaXaXaXaXcvbYbYbYbYbYbYbYbY
cxcxcxcxcxcxcxcxcxcxcxcxcxcxcxcxcxcxcxcxcxcxcxcxcxcxcxcxcxcxcxcxcxcxcxcxcxcxcxcxcxcxcxcxcxcxcxcxcxcxcxcxcxcxcxcxcxcxcxcx
aXaXaXaXaXaXaXaXaXaXaXaXaXaXaXaXaXaXaXaXaXaXaXaXaXaXaXaXaXaXaXaXaXaXaXaXaXaXaXaXaXaXaXaXaXaXaXaXaXaXaXaXaXaXaXaXaXaXaXaX
"}
