"aa" = (/turf/buildings/roof/r5,/area)
"ab" = (/turf/buildings/roof/r12,/area)
"ac" = (/turf/buildings/roof/r2,/area)
"ad" = (/turf/buildings/roof/r3,/area)
"ae" = (/turf/buildings/b5B,/area)
"af" = (/turf/buildings/b6B,/area)
"ag" = (/turf/grass,/area)
"ah" = (/turf/buildings/b4A,/area)
"ai" = (/turf/buildings/b5A,/area)
"aj" = (/turf/buildings/roof/r4,/area)
"ak" = (/turf/buildings/roof/r6,/area)
"al" = (/turf/terrain/grass_edges/e3,/turf/road,/area)
"am" = (/turf/road,/area)
"an" = (/turf/buildings/roof,/area)
"ao" = (/turf/terrain/hedge_l,/turf/grass,/area)
"ap" = (/turf/terrain/hedge,/turf/grass,/area)
"aq" = (/turf/terrain/hedge_r,/turf/grass,/area)
"ar" = (/turf/buildings/b6A,/area)
"as" = (/turf/buildings/b2B,/area)
"at" = (/turf/buildings/b3B,/area)
"au" = (/turf/terrain/grass_edges/e6,/turf/road,/area)
"av" = (/turf/terrain/grass_edges/e5,/turf/road,/area)
"aw" = (/turf/terrain/grass_edges/e7,/turf/road,/area)
"ax" = (/turf/buildings,/area)
"ay" = (/turf/buildings/b2A,/area)
"az" = (/obj/hazard/spikes,/turf/terrain/grass_edges/e5,/turf/road,/area)
"aA" = (/obj/hazard/spikes,/obj/item/shield,/turf/terrain/grass_edges/e5,/turf/road,/area)
"aB" = (/obj/hazard/portal,/turf/road,/area)
"aC" = (/obj/hazard/spikes,/turf/road,/area)
"aD" = (/obj/hazard/spikes,/obj/item/shield,/turf/road,/area)
"aE" = (/turf/terrain/grass_edges/e4,/turf/road,/area)
"aF" = (/turf/terrain/chainlink/cl_left,/turf/road,/area)
"aG" = (/turf/terrain/chainlink,/turf/road,/area)
"aH" = (/turf/terrain/chainlink/cl_right,/turf/road,/area)
"aI" = (/turf/buildings/b3A,/area)
"aJ" = (/turf/terrain/chainlink,/turf/terrain/grass_edges/e3,/turf/road,/area)
"aK" = (/turf/buildings/roof/r10,/area)
"aL" = (/turf/buildings/roof/r8,/area)
"aM" = (/turf/buildings/roof/r9,/area)
"aN" = (/turf/buildings/roof/r7,/area)
"aO" = (/turf/buildings/roof/r11,/area)
"aP" = (/turf/terrain/grass_edges/e2,/turf/road,/area)
"aQ" = (/turf/terrain/grass_edges/e8,/turf/road,/area)
"aR" = (/turf/terrain/grass_edges/e1,/turf/road,/area)
"aS" = (/turf/buildings/roof/r13,/area)
"aT" = (/turf/buildings/b4B,/area)
"aU" = (/obj/barricade/crate,/turf/grass,/area)
"aV" = (/turf/terrain/sidewalk/s9,/turf/grass,/area)
"aW" = (/obj/barricade/crate,/turf/terrain/grass_edges/e3,/turf/road,/area)
"aX" = (/obj/barricade/crate,/turf/road,/area)
"aY" = (/obj/barricade/barrel,/turf/grass,/area)
"aZ" = (/obj/barricade/crate,/turf/terrain/grass_edges/e4,/turf/road,/area)
"ba" = (/turf/buildings/b1B,/area)
"bb" = (/turf/terrain/chainlink,/turf/grass,/area)
"bc" = (/turf/terrain/sidewalk/s6,/turf/grass,/area)
"bd" = (/obj/barricade/barrel,/turf/terrain/grass_edges/e6,/turf/road,/area)
"be" = (/obj/barricade/barrel,/turf/terrain/grass_edges/e5,/turf/road,/area)
"bf" = (/obj/barricade/cone,/turf/terrain/grass_edges/e5,/turf/road,/area)
"bg" = (/obj/barricade/barrel,/turf/terrain/grass_edges/e7,/turf/road,/area)
"bh" = (/obj/barricade/barrel,/turf/road,/area)
"bi" = (/obj/markers/player_spawn,/turf/road,/area)
"bj" = (/turf/terrain/chainlink/cl_right,/obj/hazard/spikes,/turf/grass,/area)
"bk" = (/turf/terrain/grass_edges/e3,/obj/hazard/spikes,/turf/road,/area)
"bl" = (/turf/terrain/chainlink/cl_left,/obj/hazard/spikes,/turf/road,/area)
"bm" = (/turf/terrain/chainlink,/turf/terrain/grass_edges/e4,/turf/road,/area)
"bn" = (/turf/terrain/hedge_l,/turf/dirt,/area)
"bo" = (/turf/terrain/hedge,/turf/dirt,/area)
"bp" = (/turf/terrain/hedge_r,/turf/dirt,/area)
"bq" = (/turf/terrain/chainlink/cl_left,/turf/grass,/area)
"br" = (/turf/terrain/sidewalk/s3,/turf/grass,/area)
"bs" = (/turf/terrain/crosswalk/c2,/turf/road,/area)
"bt" = (/turf/terrain/sidewalk/s4,/turf/road,/area)
"bu" = (/turf/terrain/roadline,/turf/road,/area)
"bv" = (/turf/terrain/sidewalk/s8,/turf/grass,/area)

(1,1,1) = {"
aaaaabacadaeaeaeaeaeaeaeafagagagagagahaiaiaiaiaiaiaiaiaiaiaiaiaiaiaiaiaiaiaiaiaiaiaiaiaiaiaiaiaiaiaiaiaiaiaiaiaiajaaaaaaaaaaaaaaaaaaaaaaaaaaaaaaaaaaaaaaakalamamamamamamamamamamamamajagagagagagagagagag
aaaaakaeafaeaeaeaeaeaeaeafagagagagagahaiaiaiaiaiaiaiaiaiaiaiaiaiaiaiaiaiaiaiaiaiaiaiaiaiaiaiaiaiaiaiaiaiaiaiaiaiajaaaaaaaaaaaaaaaaaaaaaaaaaaaaaaaaaaaaaaakalamamamamamamamamamamamamajagagagagagagagagag
aaaaakaeafaeaeaeaeaeaeaeafagagagagagahaiaiaiaiaiaiaiaiaiaiaiaiaiaiaiaiaiaiaiaiaiaiaiaiaiaiaiaiaiaiaiaiaiaiaiaiaianacacacacacacacacacacacacacacacacacacacadalamamamamamamamamamamamamajagagagagagagagagag
aaaaakaeafaeaeaeaeaeaeaeafaoapapapaqahaiaiaiaiaiaiaiaiaiaiaiaiaiaiaiaiaiaiaiaiaiaiaiaiaiaiaiaiaiaiaiaiaiaiaiaiaiahaiaiaiaiaiaiaiaiaiaiaiaiaiaiaiaiaiaiaiaralamamamamamamamamamamamamajagagagagagagagagag
aaaaakaeafasasasasasasasatauavavavawaxayayayayayayayayayayayayayayayayayayayayayayayayayayayayayayayayayayayayayahaiaiaiaiaiaiaiaiaiaiaiaiaiaiaiaiaiaiaiaralamamamamamamamamamamamamajagagagagagagagagag
aaaaakasatagagagagagauavavamamamamamavawagagagauavazazazazaAazazazazavavavavavavavavavavavavavavavavavavavavavawahaiaiaiaiaiaiaiaiaiaiaiaiaiaiaiaiaiaiaiaralamamamamamamamamamamamamanagagagagagagagagag
aaaaakagagagauavavavamamamamamamamamamamavavavamamamamamamamamamamamamamamamaBamamamamaCaCaCaCaDaCaCaCaCamamamaEahaiaiaiaiaiaiaiaiaiaiaiaiaiaiaiaiaiaiaiaralamamamamamamamamamamamamahagagagagagagagagag
aaaaakagagauamamamamamamamamamamamamamamamamamamaFaGaGaGaGaGaGaGaGaGaGaGaGaGaGaGaGaGaGaGaGaGaGaGaGaGaGaGaHamamaEaxayayayayayayayayayayayayayayayayayayayaIaJaGaGaGaGaGaGaGaGaGaGaGaGahagagagagagagagagag
aaaaakagagalamamamamamamamamamamamamamamamamamamamamamamamamamamamamamamamamamamamamamamamamamamamamamamamamamamavavavavavavavavavavavavavavavavavavavavavamamamamamamamamamamamamamahagagagagagagagagag
aaaaakagagalamamamamamamamamamamamamamamamamamamamamamamamamamamamamamamamamamamamamamamamamamamamamamamamamamamamamamamamamamamamamamamamamamamamamamamamamamamamamamamamamamamamamahagagagagagagagagag
aaaaakagagalamamamamamamamamamamamamamamamamamamamamamamamamamamamamamamamamamamamamamamamamamamamamamamamamamamamamamamamamamamamamamamamamamamamamamamamamamamamamamamamamamamamamahagagagagagagagagag
aaaaakagagalamamamamamamamamamamamamamamamamamamamamamamamamamamamamamamamamamamamamamamamamamamamamamamamamamamamamamamamamamamamamamamamamamamamamamamamamamamamamamamamamamamamamahagagagagagagagagag
aaaaaKaLaLaLaMamamamamamamamamamamamamamamamamamamamamamamamamamamamamamamamamamamamamamamamamamamamamamamamamamamamamamamamamamamamamamamamamamamamamamamamamamamamamamamamamamamamaxagagagagagagagagag
aaaaaaaaaaaaakamamamamamamamamamaNaLaLaLaLaLaLaLaLaLaLaLaLaLaLaLaLaLaLaLaLaLaLaLaLaLaLaLaLaLaLaLaMaNaLaLaLaLaLaLaLaLaLaMamamamamamamamamamamamamamamamamamamamamamamamamamamamamamamamagagagagagagagagag
aaaaaaaaaaaaakamamamamamamamamamajaaaaaaaaaaaaaaaaaaaaaaaaaaaaaaaaaaaaaaaaaaaaaaaaaaaaaaaaaaaaaaakajaaaaaaaaaaaaaaaaaaakamamamamamamamamamamamamamamamamamamamamamamamamamamamamamamamagagagagagagagagag
aaaaaaaaaaaaakamamamamamamaNaLaLaOaaaaaaaaaaaaaaaaaaaaaaaaaaaaaaaaaaaaaaaaaaaaaaaaaaaaaaaaaaaaaaakajaaaaaaaaaaaaaaaaaaakamaPaPamamamamamamamamamamamamamamamamamamamamamamamamamamamamagagagagagagagagag
aaaaaaaaaaaaakalamamamamamajaaaaaaaaaaaaaaaaaaaaaaaaaaaaaaaaaaaaaaaaaaaaaaaaaaaaaaaaaaaaaaaaaaaaakajaaaaaaaaaaaaaaaaaaakaEagagaQaNaLaLaLaLaLaLaLaLaLaLaLaLaMamamamamamamamamamamamamamagagagagagagagagag
aaaaaaaaaaaaakalamamamamamajaaaaaaaaaaaaaaaaaaaaaaaaaaaaaaaaaaaaaaaaaaaaaaaaaaaaaaaaaaaaaaaaaaaaakajaaaaaaaaaaaaaaaaaaakaRagagagajaaaaaaaaaaaaaaaaaaaaaaaaakamamamamamamamamamamamamamagagagagagagagagag
aaaaaaabacacadalamamamamaEajaaaaaaaaaaaaaaaaaaaaaaaaaaaaaaabacacacacacacacacacacacacacacacacacacadanacacacacacacacacacadagagagagajaaaaaaaaaaaaaaaaaaaaaaaaakamamamamamamamamamamamamamagagagagagagagagag
aaaaaaakaeaeafalamamamamaEanacacaSaaaaaaaaaaaaaaaaaaaaaaaaakaiaiaiaiaiaiaiaiaiaiaiaiaiaiaiaiaiaiaraTaeaeaeaeaeaeaeaeaeafagaUagagajaaaaaaaaaaaaaaaaaaaaaaaaakamamamamamamamamamamamamamagagagagagagagagag
aaaaaaakaeaeafalamamamamaEahaiaiajaaaaaaaaaaaaaaaaaaaaaaaaakaiaiaiaiaiaiaiaiaiaiaiaiaiaiaiaiaiaiaraTaeaeaeaeaeaeaeaeaeafaUaUaUaganacacacacacacacaSaaaaaaaaakaVamamaPaPamamamamamamamamagagagagagagagagag
aaaaaaakaeaeafaWaXamamamaEahaiaiajaaaaaaaaaaaaaaaaaaaaaaaaakaiaiaiaiaiaiaiaiaiaiaiaiaiaiaiaiaiaiaraTaeaeaeaeaeaeaeaeaeafaUaUaUaYaTaeaeaeaeaeaeaeajaaaaaaaaakagamaEagagalamamamamamamamagagagagagagagagag
aaaaaaakaeaeafaWaXamamaXaZahaiaiajaaaaaaaaaaaaaaaaaaaaaaaaakayayayayayayayayayayayayayayayayayayaIbaasasasasasasasasasatbbaUaUbbbaasasasasasasasajaaaaaaaaakbcamaEagagalamamamamamamamagagagagagagagagag
aaaaaaakasasatalamamamaXaZaxayayajaaaaaaaaaaaaaaaaaaaaaaaaakbdbebeavavavavavavavavavavavavavavavavavavavavavavavavavavavavavavavbfavavavavavavawajaaaaaaaaakagamaRagagalamamamamamamamagagagagagagagagag
aaaaaaakbdbeavamamamamamamavavbgajaaaaaaaaaaaaaaaaaaaaaaaaakalbhbhamamamamambiamamamamamamamamamamamamamamamamamamamamamamamamamamamamamamamamaEajaaaaaaaaakbcagagagagalamamamamamamamagagagagagagagagag
acacacadalamamamamamamamamamamaEajaaaaaaaaaaaaaaaaaaaaaaaaakalamamamamamamamamamamamamamamamamambiamamamamamamamamamamamamamamamamamamamamamamaEajaaaaaaaaakagagagagagalamamamamamamamagagagagagagagagag
aeaeaeafalamamamamamamamamamamaEanacacacacacacacacacacacacadalamamamamamamamamamamambiamamamamamamamamamamamamamamamamamamamamamamamamamamamamaEanacacacacadbcagagauavamamamamamamamagagagagagagagagagag
aeaeaeafalamamamamamamamamamamaEahaiaiaiaiaiaiaiaiaiaiaiaiaralamamamamamamamamamamamamamamamamamamamamamamambiamamamamamamamamamamamamamamamamaEaTaeaeaeaeafagagavamamamamamamamamamagagagagagagagagagag
aeaeaeafaQaPaPaPaPaPaPaPamamamaEahaiaiaiaiaiaiaiaiaiaiaiaiaralamamamamamamamamamamamamamamamamamamamamamamamamamamamamamamamamamamamamamamamamaEbaasasasasatbcagamamamamamamamamamamagagagagagagagagagag
aeaeaeafagagagagagagagagalamamaEahaiaiaiaiaiaiaiaiaiaiaiaiaralamamamamamamamamamamamamamamamamamamamamamamamamamamamamamamamamamamamamamamamamaEagaoapapaqagagagamamamamamamamaPaPaPagagagagagagagagagag
asasasatbbbbbbbbbbbbbbbjbkblaGbmaxayayayayayayayayayayayayaIaJaHamamamaFaGaGbnbobobobobpaGaGbnbobobobobobobobobobobpaGaGaGaGaGaGaGaGaHamamamamaEagagagagagagbcamamamamamamamaEbqbbbbagagagagagagagagagag
agagagagagagagagagagagagamamamamagagagagagagagagagagagagagagamamamamamamagagagagagagagagagagagagagagagagagagagagagagagagagagagagagagamamamamamamagagagagagamamamamamamamamamaEagagagagagagagagagagagagag
bragbragbragbragbragbragamamamambragbragbragbragbragbragbragbsbsbsbsbsbsbragbragbragbragbragbragbragbragbragbragbragbragbragbragbragbsbsbsbsbsbsbragbragbrambtamamamamamamagagagagagagagagagagagagagagag
amamamamamamamamamamamamamamamamamamamamamamamamamamamamamamamamamamamamamamamamamamamamamamamamamamamamamamamamamamamamamamamamamamamamamamamamamamamamamamamamamamamamamagagagagagagagagagagagagagagag
amamamamamamamamamamamamamamamamamamamamamamamamamamamamamamamamamamamamamamamamamamamamamamamamamamamamamamamamamamamamamamamamamamamamamamamamamamamamamamamamamamamamamagagagagagagagagagagagagagagag
amamamamamamamamamamamamamamamamamamamamamamamamamamamamamamamamamamamamamamamamamamamamamamamamamamamamamamamamamamamamamamamamamamamamamamamamamamamamamamamamamamamamamagagagagagagagagagagagagagagag
amamamamamamamamamamamamamamamamamamamamamamamamamamamamamamamamamamamamamamamamamamamamamamamamamamamamamamamamamamamamamamamamamamamamamamamamamamamamamamamamamamamamamagagagagagagagagagagagagagagag
amambububububububububububububububububububububububububububububububububububububububububububububububububububububububububububububububububububuamamamamamamamamamamamamamamamamagagagagagagagagagagagagagagag
amamamamamamamamamamamamamamamamamamamamamamamamamamamamamamamamamamamamamamamamamamamamamamamamamamamamamamamamamamamamamamamamamamamamamamamamamamamamamamamamamamamamamagagagagagagagagagagagagagagag
amamamamamamamamamamamamamamamamamamamamamamamamamamamamamamamamamamamamamamamamamamamamamamamamamamamamamamamamamamamamamamamamamamamamamamamamamamamamamamamamamamamamamagagagagagagagagagagagagagagag
amamamamamamamamamamamamamamamamamamamamamamamamamamamamamamamamamamamamamamamamamamamamamamamamamamamamamamamamamamamamamamamamamamamamamamamamamamamamamamamamamamamamamagagagagagagagagagagagagagagag
amamamamamamamamamamamamamamamamamamamamamamamamamamamamamamamamamamamamamamamamamamamamamamamamamamamamamamamamamamamamamamamamamamamamamamamamamamamamamamamamamamamamamagagagagagagagagagagagagagagag
agagagagagagagagagagagagagagagagagagagagagagagagagagagagagagagagagagagagagagagagagagagagagagagagagagagagagagagagagagagagagagagagagagagagagagagagagamamamamamamamamamamamamagagagagagagagagagagagagagagag
bvagbvagbvagbvagbvagbvagbvagbvagbvagbvagbvagbvagbvagbvagbvagbvagbvagbvagbvagbvagbvagbvagbvagbvagbvagbvagbvagbvagbvagbvagbvagbvagbvagbvagbvagbvagbvamamamamamamamamamamamamagagagagagagagagagagagagagagag
agagagagagagagagagagagagagagagagagagagagagagagagagagagagagagagagagagagagagagagagagagagagagagagagagagagagagagagagagagagagagagagagagagagagagagagagagagagagagagagagagagagagagagagagagagagagagagagagagagagag
agagagagagagagagagagagagagagagagagagagagagagagagagagagagagagagagagagagagagagagagagagagagagagagagagagagagagagagagagagagagagagagagagagagagagagagagagagagagagagagagagagagagagagagagagagagagagagagagagagagag
agagagagagagagagagagagagagagagagagagagagagagagagagagagagagagagagagagagagagagagagagagagagagagagagagagagagagagagagagagagagagagagagagagagagagagagagagagagagagagagagagagagagagagagagagagagagagagagagagagagag
agagagagagagagagagagagagagagagagagagagagagagagagagagagagagagagagagagagagagagagagagagagagagagagagagagagagagagagagagagagagagagagagagagagagagagagagagagagagagagagagagagagagagagagagagagagagagagagagagagagag
agagagagagagagagagagagagagagagagagagagagagagagagagagagagagagagagagagagagagagagagagagagagagagagagagagagagagagagagagagagagagagagagagagagagagagagagagagagagagagagagagagagagagagagagagagagagagagagagagagagag
agagagagagagagagagagagagagagagagagagagagagagagagagagagagagagagagagagagagagagagagagagagagagagagagagagagagagagagagagagagagagagagagagagagagagagagagagagagagagagagagagagagagagagagagagagagagagagagagagagagag
agagagagagagagagagagagagagagagagagagagagagagagagagagagagagagagagagagagagagagagagagagagagagagagagagagagagagagagagagagagagagagagagagagagagagagagagagagagagagagagagagagagagagagagagagagagagagagagagagagagag
agagagagagagagagagagagagagagagagagagagagagagagagagagagagagagagagagagagagagagagagagagagagagagagagagagagagagagagagagagagagagagagagagagagagagagagagagagagagagagagagagagagagagagagagagagagagagagagagagagagag
agagagagagagagagagagagagagagagagagagagagagagagagagagagagagagagagagagagagagagagagagagagagagagagagagagagagagagagagagagagagagagagagagagagagagagagagagagagagagagagagagagagagagagagagagagagagagagagagagagagag
agagagagagagagagagagagagagagagagagagagagagagagagagagagagagagagagagagagagagagagagagagagagagagagagagagagagagagagagagagagagagagagagagagagagagagagagagagagagagagagagagagagagagagagagagagagagagagagagagagagag
agagagagagagagagagagagagagagagagagagagagagagagagagagagagagagagagagagagagagagagagagagagagagagagagagagagagagagagagagagagagagagagagagagagagagagagagagagagagagagagagagagagagagagagagagagagagagagagagagagagag
agagagagagagagagagagagagagagagagagagagagagagagagagagagagagagagagagagagagagagagagagagagagagagagagagagagagagagagagagagagagagagagagagagagagagagagagagagagagagagagagagagagagagagagagagagagagagagagagagagagag
agagagagagagagagagagagagagagagagagagagagagagagagagagagagagagagagagagagagagagagagagagagagagagagagagagagagagagagagagagagagagagagagagagagagagagagagagagagagagagagagagagagagagagagagagagagagagagagagagagagag
agagagagagagagagagagagagagagagagagagagagagagagagagagagagagagagagagagagagagagagagagagagagagagagagagagagagagagagagagagagagagagagagagagagagagagagagagagagagagagagagagagagagagagagagagagagagagagagagagagagag
agagagagagagagagagagagagagagagagagagagagagagagagagagagagagagagagagagagagagagagagagagagagagagagagagagagagagagagagagagagagagagagagagagagagagagagagagagagagagagagagagagagagagagagagagagagagagagagagagagagag
agagagagagagagagagagagagagagagagagagagagagagagagagagagagagagagagagagagagagagagagagagagagagagagagagagagagagagagagagagagagagagagagagagagagagagagagagagagagagagagagagagagagagagagagagagagagagagagagagagagag
agagagagagagagagagagagagagagagagagagagagagagagagagagagagagagagagagagagagagagagagagagagagagagagagagagagagagagagagagagagagagagagagagagagagagagagagagagagagagagagagagagagagagagagagagagagagagagagagagagagag
agagagagagagagagagagagagagagagagagagagagagagagagagagagagagagagagagagagagagagagagagagagagagagagagagagagagagagagagagagagagagagagagagagagagagagagagagagagagagagagagagagagagagagagagagagagagagagagagagagagag
agagagagagagagagagagagagagagagagagagagagagagagagagagagagagagagagagagagagagagagagagagagagagagagagagagagagagagagagagagagagagagagagagagagagagagagagagagagagagagagagagagagagagagagagagagagagagagagagagagagag
agagagagagagagagagagagagagagagagagagagagagagagagagagagagagagagagagagagagagagagagagagagagagagagagagagagagagagagagagagagagagagagagagagagagagagagagagagagagagagagagagagagagagagagagagagagagagagagagagagagag
agagagagagagagagagagagagagagagagagagagagagagagagagagagagagagagagagagagagagagagagagagagagagagagagagagagagagagagagagagagagagagagagagagagagagagagagagagagagagagagagagagagagagagagagagagagagagagagagagagagag
agagagagagagagagagagagagagagagagagagagagagagagagagagagagagagagagagagagagagagagagagagagagagagagagagagagagagagagagagagagagagagagagagagagagagagagagagagagagagagagagagagagagagagagagagagagagagagagagagagagag
agagagagagagagagagagagagagagagagagagagagagagagagagagagagagagagagagagagagagagagagagagagagagagagagagagagagagagagagagagagagagagagagagagagagagagagagagagagagagagagagagagagagagagagagagagagagagagagagagagagag
agagagagagagagagagagagagagagagagagagagagagagagagagagagagagagagagagagagagagagagagagagagagagagagagagagagagagagagagagagagagagagagagagagagagagagagagagagagagagagagagagagagagagagagagagagagagagagagagagagagag
agagagagagagagagagagagagagagagagagagagagagagagagagagagagagagagagagagagagagagagagagagagagagagagagagagagagagagagagagagagagagagagagagagagagagagagagagagagagagagagagagagagagagagagagagagagagagagagagagagagag
agagagagagagagagagagagagagagagagagagagagagagagagagagagagagagagagagagagagagagagagagagagagagagagagagagagagagagagagagagagagagagagagagagagagagagagagagagagagagagagagagagagagagagagagagagagagagagagagagagagag
agagagagagagagagagagagagagagagagagagagagagagagagagagagagagagagagagagagagagagagagagagagagagagagagagagagagagagagagagagagagagagagagagagagagagagagagagagagagagagagagagagagagagagagagagagagagagagagagagagagag
agagagagagagagagagagagagagagagagagagagagagagagagagagagagagagagagagagagagagagagagagagagagagagagagagagagagagagagagagagagagagagagagagagagagagagagagagagagagagagagagagagagagagagagagagagagagagagagagagagagag
agagagagagagagagagagagagagagagagagagagagagagagagagagagagagagagagagagagagagagagagagagagagagagagagagagagagagagagagagagagagagagagagagagagagagagagagagagagagagagagagagagagagagagagagagagagagagagagagagagagag
agagagagagagagagagagagagagagagagagagagagagagagagagagagagagagagagagagagagagagagagagagagagagagagagagagagagagagagagagagagagagagagagagagagagagagagagagagagagagagagagagagagagagagagagagagagagagagagagagagagag
agagagagagagagagagagagagagagagagagagagagagagagagagagagagagagagagagagagagagagagagagagagagagagagagagagagagagagagagagagagagagagagagagagagagagagagagagagagagagagagagagagagagagagagagagagagagagagagagagagagag
agagagagagagagagagagagagagagagagagagagagagagagagagagagagagagagagagagagagagagagagagagagagagagagagagagagagagagagagagagagagagagagagagagagagagagagagagagagagagagagagagagagagagagagagagagagagagagagagagagagag
agagagagagagagagagagagagagagagagagagagagagagagagagagagagagagagagagagagagagagagagagagagagagagagagagagagagagagagagagagagagagagagagagagagagagagagagagagagagagagagagagagagagagagagagagagagagagagagagagagagag
agagagagagagagagagagagagagagagagagagagagagagagagagagagagagagagagagagagagagagagagagagagagagagagagagagagagagagagagagagagagagagagagagagagagagagagagagagagagagagagagagagagagagagagagagagagagagagagagagagagag
agagagagagagagagagagagagagagagagagagagagagagagagagagagagagagagagagagagagagagagagagagagagagagagagagagagagagagagagagagagagagagagagagagagagagagagagagagagagagagagagagagagagagagagagagagagagagagagagagagagag
agagagagagagagagagagagagagagagagagagagagagagagagagagagagagagagagagagagagagagagagagagagagagagagagagagagagagagagagagagagagagagagagagagagagagagagagagagagagagagagagagagagagagagagagagagagagagagagagagagagag
agagagagagagagagagagagagagagagagagagagagagagagagagagagagagagagagagagagagagagagagagagagagagagagagagagagagagagagagagagagagagagagagagagagagagagagagagagagagagagagagagagagagagagagagagagagagagagagagagagagag
agagagagagagagagagagagagagagagagagagagagagagagagagagagagagagagagagagagagagagagagagagagagagagagagagagagagagagagagagagagagagagagagagagagagagagagagagagagagagagagagagagagagagagagagagagagagagagagagagagagag
agagagagagagagagagagagagagagagagagagagagagagagagagagagagagagagagagagagagagagagagagagagagagagagagagagagagagagagagagagagagagagagagagagagagagagagagagagagagagagagagagagagagagagagagagagagagagagagagagagagag
agagagagagagagagagagagagagagagagagagagagagagagagagagagagagagagagagagagagagagagagagagagagagagagagagagagagagagagagagagagagagagagagagagagagagagagagagagagagagagagagagagagagagagagagagagagagagagagagagagagag
agagagagagagagagagagagagagagagagagagagagagagagagagagagagagagagagagagagagagagagagagagagagagagagagagagagagagagagagagagagagagagagagagagagagagagagagagagagagagagagagagagagagagagagagagagagagagagagagagagagag
agagagagagagagagagagagagagagagagagagagagagagagagagagagagagagagagagagagagagagagagagagagagagagagagagagagagagagagagagagagagagagagagagagagagagagagagagagagagagagagagagagagagagagagagagagagagagagagagagagagag
agagagagagagagagagagagagagagagagagagagagagagagagagagagagagagagagagagagagagagagagagagagagagagagagagagagagagagagagagagagagagagagagagagagagagagagagagagagagagagagagagagagagagagagagagagagagagagagagagagagag
agagagagagagagagagagagagagagagagagagagagagagagagagagagagagagagagagagagagagagagagagagagagagagagagagagagagagagagagagagagagagagagagagagagagagagagagagagagagagagagagagagagagagagagagagagagagagagagagagagagag
agagagagagagagagagagagagagagagagagagagagagagagagagagagagagagagagagagagagagagagagagagagagagagagagagagagagagagagagagagagagagagagagagagagagagagagagagagagagagagagagagagagagagagagagagagagagagagagagagagagag
agagagagagagagagagagagagagagagagagagagagagagagagagagagagagagagagagagagagagagagagagagagagagagagagagagagagagagagagagagagagagagagagagagagagagagagagagagagagagagagagagagagagagagagagagagagagagagagagagagagag
agagagagagagagagagagagagagagagagagagagagagagagagagagagagagagagagagagagagagagagagagagagagagagagagagagagagagagagagagagagagagagagagagagagagagagagagagagagagagagagagagagagagagagagagagagagagagagagagagagagag
agagagagagagagagagagagagagagagagagagagagagagagagagagagagagagagagagagagagagagagagagagagagagagagagagagagagagagagagagagagagagagagagagagagagagagagagagagagagagagagagagagagagagagagagagagagagagagagagagagagag
agagagagagagagagagagagagagagagagagagagagagagagagagagagagagagagagagagagagagagagagagagagagagagagagagagagagagagagagagagagagagagagagagagagagagagagagagagagagagagagagagagagagagagagagagagagagagagagagagagagag
agagagagagagagagagagagagagagagagagagagagagagagagagagagagagagagagagagagagagagagagagagagagagagagagagagagagagagagagagagagagagagagagagagagagagagagagagagagagagagagagagagagagagagagagagagagagagagagagagagagag
agagagagagagagagagagagagagagagagagagagagagagagagagagagagagagagagagagagagagagagagagagagagagagagagagagagagagagagagagagagagagagagagagagagagagagagagagagagagagagagagagagagagagagagagagagagagagagagagagagagag
agagagagagagagagagagagagagagagagagagagagagagagagagagagagagagagagagagagagagagagagagagagagagagagagagagagagagagagagagagagagagagagagagagagagagagagagagagagagagagagagagagagagagagagagagagagagagagagagagagagag
agagagagagagagagagagagagagagagagagagagagagagagagagagagagagagagagagagagagagagagagagagagagagagagagagagagagagagagagagagagagagagagagagagagagagagagagagagagagagagagagagagagagagagagagagagagagagagagagagagagag
agagagagagagagagagagagagagagagagagagagagagagagagagagagagagagagagagagagagagagagagagagagagagagagagagagagagagagagagagagagagagagagagagagagagagagagagagagagagagagagagagagagagagagagagagagagagagagagagagagagag
agagagagagagagagagagagagagagagagagagagagagagagagagagagagagagagagagagagagagagagagagagagagagagagagagagagagagagagagagagagagagagagagagagagagagagagagagagagagagagagagagagagagagagagagagagagagagagagagagagagag
agagagagagagagagagagagagagagagagagagagagagagagagagagagagagagagagagagagagagagagagagagagagagagagagagagagagagagagagagagagagagagagagagagagagagagagagagagagagagagagagagagagagagagagagagagagagagagagagagagagag
"}
