"aa" = (/turf/buildings/roof/r5,/area)
"ab" = (/turf/buildings/roof/r12,/area)
"ac" = (/turf/buildings/roof/r2,/area)
"ad" = (/turf/buildings/roof/r3,/area)
"ae" = (/turf/buildings/b5B,/area)
"af" = (/turf/buildings/b6B,/area)
"ag" = (/turf/grass,/area)
"ah" = (/turf/buildings/b4A,/area)
"ai" = (/turf/buildings/b5A,/area)
"aj" = (/turf/buildings/roof/r4,/area)
"ak" = (/turf/buildings/roof/r6,/area)
"al" = (/turf/buildings/b4B,/area)
"am" = (/turf/buildings/b1B,/area)
"an" = (/turf/buildings/b2B,/area)
"ao" = (/obj/markers/dense,/turf/buildings/b2B,/area)
"ap" = (/turf/buildings/b3B,/area)
"aq" = (/turf/buildings/roof,/area)
"ar" = (/turf/terrain/grass_edges/e6,/turf/terrain/trashbag,/turf/road,/area)
"as" = (/turf/terrain/grass_edges/e5,/turf/terrain/trashbag,/turf/road,/area)
"at" = (/turf/terrain/grass_edges/e5,/turf/road,/area)
"au" = (/turf/terrain/grass_edges/e5,/obj/barricade/barrel,/turf/road,/area)
"av" = (/obj/markers/dense,/turf/road,/area)
"aw" = (/turf/road,/area)
"ax" = (/turf/terrain/grass_edges/e7,/turf/road,/area)
"ay" = (/turf/terrain/hedge_l,/turf/grass,/area)
"az" = (/turf/terrain/hedge,/turf/grass,/area)
"aA" = (/turf/terrain/hedge_r,/turf/grass,/area)
"aB" = (/turf/buildings/b5A,/turf/buildings/details/long_window,/area)
"aC" = (/turf/buildings/b6A,/area)
"aD" = (/turf/terrain/grass_edges/e3,/turf/terrain/trashbag,/turf/road,/area)
"aE" = (/obj/item/gun/pink_dream,/turf/road,/area)
"aF" = (/obj/item/shield,/turf/road,/area)
"aG" = (/turf/terrain/trashbag,/turf/road,/area)
"aH" = (/turf/terrain/dumpster,/obj/markers/dense,/turf/road,/area)
"aI" = (/turf/terrain/grass_edges/e4,/turf/terrain/grass_edges/e4,/turf/road,/area)
"aJ" = (/turf/terrain/grass_edges/e6,/obj/markers/enemy_spawn,/turf/road,/area)
"aK" = (/turf/terrain/grass_edges/e5,/obj/markers/enemy_spawn,/turf/road,/area)
"aL" = (/turf/terrain/grass_edges/e7,/obj/markers/enemy_spawn,/turf/road,/area)
"aM" = (/turf/buildings,/area)
"aN" = (/turf/buildings/b2A,/area)
"aO" = (/turf/terrain/grass_edges/e3,/turf/road,/area)
"aP" = (/turf/terrain/sewer,/turf/road,/area)
"aQ" = (/turf/terrain/grass_edges/e4,/turf/terrain/trashbag,/turf/road,/area)
"aR" = (/turf/terrain/tree,/turf/grass,/area)
"aS" = (/obj/barricade/barrel,/turf/grass,/area)
"aT" = (/obj/markers/dense,/turf/grass,/area)
"aU" = (/turf/terrain/grass_edges/e6,/turf/road,/area)
"aV" = (/obj/markers/enemy_spawn,/turf/road,/area)
"aW" = (/turf/terrain/grass_edges/e7,/obj/barricade/barrel,/turf/road,/area)
"aX" = (/obj/hazard/spikes,/turf/terrain/grass_edges/e5,/turf/road,/area)
"aY" = (/obj/hazard/spikes,/obj/item/shield,/turf/terrain/grass_edges/e5,/turf/road,/area)
"aZ" = (/turf/terrain/grass_edges/e5,/turf/terrain/effects/firefly,/turf/road,/area)
"ba" = (/turf/terrain/grass_edges/e7,/turf/terrain/trashbag,/turf/road,/area)
"bb" = (/turf/terrain/grass_edges/e4,/turf/road,/area)
"bc" = (/turf/buildings/roof/r13,/area)
"bd" = (/obj/item/gun/edge_lord,/turf/grass,/area)
"be" = (/turf/terrain/details/grass_sprouts,/turf/road,/area)
"bf" = (/turf/terrain/details/grass_sprouts,/turf/terrain/details/grass_sprouts,/turf/road,/area)
"bg" = (/obj/hazard/portal,/turf/road,/area)
"bh" = (/obj/hazard/spikes,/turf/road,/area)
"bi" = (/obj/hazard/spikes,/obj/item/shield,/turf/road,/area)
"bj" = (/turf/terrain/chainlink/cl_left,/turf/road,/area)
"bk" = (/turf/terrain/chainlink,/turf/road,/area)
"bl" = (/turf/terrain/chainlink/cl_right,/turf/road,/area)
"bm" = (/obj/hazard/fire{layer = 4},/turf/buildings/b2A,/area)
"bn" = (/turf/buildings/b3A,/area)
"bo" = (/turf/terrain/chainlink,/turf/terrain/grass_edges/e4,/turf/road,/area)
"bp" = (/turf/terrain/trashbag,/turf/grass,/area)
"bq" = (/obj/barricade/barrel,/turf/road,/area)
"br" = (/turf/terrain/grass_edges/e5,/obj/hazard/fire,/turf/road,/area)
"bs" = (/turf/terrain/grass_edges/e5,/turf/terrain/trashbag,/obj/hazard/fire,/turf/road,/area)
"bt" = (/turf/terrain/grass_edges/e5,/obj/hazard/fire{layer = 4},/turf/road,/area)
"bu" = (/turf/terrain/grass_edges/e4,/turf/terrain/details/grass_sprouts,/turf/road,/area)
"bv" = (/turf/terrain/sewer,/obj/markers/enemy_spawn,/turf/road,/area)
"bw" = (/turf/terrain/effects/firefly,/obj/markers/enemy_spawn,/turf/road,/area)
"bx" = (/turf/terrain/effects/firefly,/turf/road,/area)
"by" = (/obj/barricade/barrel,/obj/markers/enemy_spawn,/turf/road,/area)
"bz" = (/turf/terrain/details/grass_sprouts,/obj/markers/enemy_spawn,/turf/road,/area)
"bA" = (/turf/terrain/dumpster,/obj/markers/enemy_spawn,/turf/road,/area)
"bB" = (/turf/terrain/trashbag,/obj/hazard/fire,/obj/markers/enemy_spawn,/turf/road,/area)
"bC" = (/turf/terrain/trashbag,/obj/markers/enemy_spawn,/turf/road,/area)
"bD" = (/turf/terrain/obelisk,/turf/road,/area)
"bE" = (/turf/terrain/effects/cloud,/obj/markers/enemy_spawn,/turf/road,/area)
"bF" = (/turf/buildings/roof/r10,/area)
"bG" = (/turf/buildings/roof/r8,/area)
"bH" = (/turf/buildings/roof/r9,/area)
"bI" = (/turf/terrain/effects/cloud,/turf/road,/area)
"bJ" = (/turf/terrain/helipad,/turf/road,/area)
"bK" = (/turf/buildings/roof/r7,/area)
"bL" = (/turf/terrain/pentagram,/obj/markers/enemy_spawn,/turf/road,/area)
"bM" = (/obj/barricade/crate,/turf/road,/area)
"bN" = (/turf/buildings/roof/r11,/area)
"bO" = (/turf/terrain/grass_edges/e2,/turf/terrain/details/grass_sprouts,/turf/road,/area)
"bP" = (/turf/terrain/grass_edges/e8,/turf/road,/area)
"bQ" = (/turf/terrain/effects/cloud,/turf/terrain/details/grass_sprouts,/obj/markers/enemy_spawn,/turf/road,/area)
"bR" = (/turf/terrain/effects/cloud,/turf/buildings/roof/r5,/area)
"bS" = (/turf/terrain/billboard,/turf/buildings/roof/r5,/area)
"bT" = (/turf/terrain/grass_edges/e1,/turf/road,/area)
"bU" = (/obj/barricade/crate,/turf/grass,/area)
"bV" = (/turf/terrain/sidewalk/s9,/turf/grass,/area)
"bW" = (/turf/terrain/grass_edges/e2,/turf/road,/area)
"bX" = (/obj/barricade/crate,/turf/terrain/grass_edges/e3,/turf/road,/area)
"bY" = (/turf/buildings/b5B,/turf/buildings/details/long_window,/area)
"bZ" = (/obj/barricade/crate,/turf/terrain/grass_edges/e4,/turf/road,/area)
"ca" = (/turf/terrain/chainlink,/turf/grass,/area)
"cb" = (/turf/terrain/sidewalk/s6,/turf/grass,/area)
"cc" = (/obj/barricade/barrel,/turf/terrain/grass_edges/e6,/turf/road,/area)
"cd" = (/obj/barricade/barrel,/turf/terrain/grass_edges/e5,/turf/road,/area)
"ce" = (/turf/terrain/grass_edges/e5,/turf/terrain/details/grass_sprouts,/turf/road,/area)
"cf" = (/turf/terrain/grass_edges/e5,/obj/item/health_pack,/turf/road,/area)
"cg" = (/obj/barricade/cone,/turf/terrain/grass_edges/e5,/turf/road,/area)
"ch" = (/obj/barricade/barrel,/turf/terrain/grass_edges/e7,/turf/road,/area)
"ci" = (/obj/item/revive_pack,/turf/road,/area)
"cj" = (/obj/markers/player_spawn,/turf/road,/area)
"ck" = (/obj/item/gun/kobra,/turf/road,/area)
"cl" = (/obj/item/special/molotov,/turf/road,/area)
"cm" = (/turf/terrain/sidewalk/s6,/obj/barricade/barrel,/turf/grass,/area)
"cn" = (/turf/terrain/crashed_car,/obj/markers/dense,/turf/road,/area)
"co" = (/turf/terrain/grass_edges/e3,/turf/terrain/details/grass_sprouts,/turf/road,/area)
"cp" = (/obj/item/health_pack,/turf/road,/area)
"cq" = (/turf/terrain/grass_edges/e3,/obj/item/strong_shield,/turf/road,/area)
"cr" = (/obj/item/special/airstrike,/turf/road,/area)
"cs" = (/obj/item/gun/red_baron,/turf/road,/area)
"ct" = (/turf/terrain/details/grass_sprouts,/obj/item/revive_pack,/turf/road,/area)
"cu" = (/turf/terrain/grass_edges/e2,/obj/markers/enemy_spawn,/turf/road,/area)
"cv" = (/turf/terrain/grass_edges/e2,/turf/terrain/pentagram,/turf/road,/area)
"cw" = (/turf/terrain/pentagram,/turf/road,/area)
"cx" = (/obj/item/gun/uzi,/turf/road,/area)
"cy" = (/turf/buildings/b2B,/turf/buildings/details/long_window,/area)
"cz" = (/turf/terrain/chainlink/cl_right,/obj/hazard/spikes,/turf/grass,/area)
"cA" = (/turf/terrain/grass_edges/e3,/obj/hazard/spikes,/turf/road,/area)
"cB" = (/turf/terrain/chainlink/cl_left,/obj/hazard/spikes,/turf/road,/area)
"cC" = (/turf/terrain/chainlink,/turf/terrain/grass_edges/e3,/turf/road,/area)
"cD" = (/turf/terrain/hedge_l,/turf/dirt,/area)
"cE" = (/turf/terrain/hedge,/turf/dirt,/area)
"cF" = (/turf/terrain/hedge_r,/turf/dirt,/area)
"cG" = (/turf/terrain/effects/firefly,/turf/grass,/area)
"cH" = (/turf/terrain/grass_edges/e4,/obj/markers/enemy_spawn,/turf/road,/area)
"cI" = (/turf/terrain/chainlink/cl_left,/obj/markers/enemy_spawn,/turf/grass,/area)
"cJ" = (/obj/barricade/cone,/turf/grass,/area)
"cK" = (/turf/terrain/grass_edges/e1,/obj/markers/enemy_spawn,/turf/road,/area)
"cL" = (/obj/markers/enemy_spawn,/turf/grass,/area)
"cM" = (/turf/terrain/sidewalk/s3,/obj/hazard/fire,/turf/grass,/area)
"cN" = (/turf/terrain/sidewalk/s3,/obj/barricade/crate,/turf/grass,/area)
"cO" = (/turf/terrain/sidewalk/s3,/turf/grass,/area)
"cP" = (/turf/terrain/crosswalk/c2,/turf/road,/area)
"cQ" = (/turf/terrain/sidewalk/s4,/turf/road,/area)
"cR" = (/turf/terrain/tree,/obj/markers/enemy_spawn,/turf/grass,/area)
"cS" = (/obj/hazard/fire,/turf/road,/area)
"cT" = (/turf/terrain/crosswalk,/turf/road,/area)
"cU" = (/turf/terrain/crashed_car,/turf/road,/area)
"cV" = (/obj/gore/blood,/turf/road,/area)
"cW" = (/turf/terrain/car,/turf/road,/area)
"cX" = (/turf/terrain/car,/obj/markers/dense,/turf/road,/area)
"cY" = (/obj/hazard/portal,/turf/grass,/area)
"cZ" = (/obj/barricade/cone,/turf/road,/area)
"da" = (/obj/markers/enemy_spawn,/obj/markers/enemy_spawn,/turf/road,/area)
"db" = (/turf/terrain/roadline,/turf/road,/area)
"dc" = (/turf/terrain/roadline,/obj/markers/enemy_spawn,/turf/road,/area)
"dd" = (/turf/terrain/car,/obj/hazard/fire,/turf/road,/area)
"de" = (/turf/terrain/car,/obj/hazard/fire,/turf/grass,/area)
"df" = (/turf/terrain/sidewalk/s8,/obj/hazard/fire,/turf/grass,/area)
"dg" = (/turf/terrain/sidewalk/s8,/obj/barricade/cone,/turf/grass,/area)
"dh" = (/obj/barricade/cone,/obj/overlays/chainlink{name = "chainlink pixel down"; pixel_y = -16},/turf/grass,/area)
"di" = (/turf/terrain/sidewalk/s8,/obj/barricade/cone,/obj/overlays/chainlink{name = "chainlink pixel down"; pixel_y = -16},/turf/grass,/area)
"dj" = (/obj/barricade/crate,/obj/overlays/chainlink{name = "chainlink pixel down"; pixel_y = -16},/turf/grass,/area)
"dk" = (/turf/terrain/sidewalk/s8,/obj/overlays/chainlink{name = "chainlink pixel down"; pixel_y = -16},/turf/grass,/area)
"dl" = (/obj/markers/enemy_spawn,/obj/overlays/chainlink{name = "chainlink pixel down"; pixel_y = -16},/turf/grass,/area)
"dm" = (/turf/terrain/sidewalk/s8,/obj/markers/enemy_spawn,/obj/overlays/chainlink{name = "chainlink pixel down"; pixel_y = -16},/turf/grass,/area)
"dn" = (/obj/overlays/chainlink{name = "chainlink pixel down"; pixel_y = -16},/turf/grass,/area)
"do" = (/obj/markers/enemy_spawn,/obj/overlays/chainlink{name = "chainlink pixel down"; pixel_y = -16},/turf/road,/area)
"dp" = (/turf/terrain/sidewalk/s8,/obj/markers/enemy_spawn,/obj/overlays/chainlink{name = "chainlink pixel down"; pixel_y = -16},/turf/road,/area)

(1,1,1) = {"
aaaaabacadaeaeaeaeaeaeaeafagagagagagahaiaiaiaiaiaiaiaiaiaiaiaiaiaiaiaiaiaiaiaiaiaiaiaiaiaiaiaiaiaiaiaiaiaiaiaiaiajaaaaaaaaaaaaaaaaaaaaaaaaaaaaaaaaaaaaaaakalaeaeaeaeaeaeaeaeaeaeaeafajaaaaaaaaaaaaaaaaaa
aaaaakaeafaeaeaeaeaeaeaeafagagagagagahaiaiaiaiaiaiaiaiaiaiaiaiaiaiaiaiaiaiaiaiaiaiaiaiaiaiaiaiaiaiaiaiaiaiaiaiaiajaaaaaaaaaaaaaaaaaaaaaaaaaaaaaaaaaaaaaaakamanananananananananaoaoapajaaaaaaaaaaaaaaaaaa
aaaaakaeafaeaeaeaeaeaeaeafagagagagagahaiaiaiaiaiaiaiaiaiaiaiaiaiaiaiaiaiaiaiaiaiaiaiaiaiaiaiaiaiaiaiaiaiaiaiaiaiaqacacacacacacacacacacacacacacacacacacacadarasatatauauasasatavavawaxajaaaaaaaaaaaaaaaaaa
aaaaakaeafaeaeaeaeaeaeaeafayazazazaAahaiaiaiaiaiaiaiaBaiaiaiaiaiaiaiaiaiaiaBaiaiaiaiaiaiaiaiaiaiaBaiaiaiaiaiaiaiahaiaiaiaiaiaiaiaiaiaiaiaiaiaiaiaiaiaiaiaCaDaEawawawawawaFaGaHavavaIajaaaaaaaaaaaaaaaaaa
aaaaakaeafanananananananapaJaKaKaKaLaMaNaNaNaNaNaNaNaNaNaNaNaNaNaNaNaNaNaNaNaNaNaNaNaNaNaNaNaNaNaNaNaNaNaNaNaNaNahaBaiaiaiaiaiaBaiaiaiaiaiaBaiaiaiaiaiaiaCaOaPawawawawawawawawawawaQajaaaaaaaaaaaaaaaaaa
aaaaakanapaRaSaTaTagaUataKaVawaVaVaVataWayazaAaUataXaXaXaXaYaXaXaXaXaZatatatatatatatatatatatatatatatatatatatatbaahaiaiaiaiaiaiaiaiaiaiaiaiaiaiaiaiaiaiaiaCaOawawawaFawawawawawawaGbbaqbcaaaaaaaaaaaaaaaa
aaaaakagbdagaUauatatawawawawbebfbeawawawatatatawawawawawawawawawawawawawawawbgawawawawbhbhbhbhbibhbhbhbhawawawbbahaiaiaiaBaiaiaiaiaiaBaiaiaiaiaiaBaiaiaiaCaOawbebeawawawawawawaGaGbbahajaaaaaaaaaaaaaaaa
aaaaakagagaUawawawawawawawawawbebeawawawawawawawbjbkbkbkbkbkbkbkbkbkbkbkbkbkbkbkbkbkbkbkbkbkbkbkbkbkbkbkblawawbbaMaNaNaNbmbmaNaNbmbmaNaNaNaNaNaNaNaNaNaNbnaOawawbebjbkbkbkbkbkbkbkboahajaaaaaaaaaaaaaaaa
aaaaakbpagaOaVaVaVaVaVaVaVaVawawbebeawawawawawawawawawawbebeawawawawawawawawbqawawawbqbqawawawawawawawawawawawawatatasbratatatbsatbtatatasatatatatatatatatawbeawawawawawaVawbebebebuahajaaaaaaaaaaaaaaaa
aaaaakaSbpaObvaVaVaVbwaVaVaVaVaVaVawawavavavavawawbxawawawawawawawavavavavawawawbyaVaVaVbzaVawawavavavavawawawawawawbqaGbAaVaVbBbAaVaVbCaVaVaVaVaVaVaVaVaVbzawawaVawawawawawawawbebuahajaaaaaaaaaaaaaaaa
aaaaakagagaOaVaVaVaVaVaVaVaVaVaVaVawbDavavavavawawawawawawawawawbDavavavavawawawaVaVaVbzaVaVawbDavavavavaVbEaVaVaVawawbqaVaVbCbCaVaVbCaVaVbzaVaVaVaVaVbwbzbzawawawawawaVaVawawaVawbbahajaaaaaaaaaaaaaaaa
aaaaakagagaOaVaVaVaVaVaVaVaVaVaVaVawawawawawawawbebeawbeawawawawawawawawawawawawaVbzaVbzbzaVbxawawawbqawaVaVaVaVaVawawawbzaVaVaVaVaVaVaVaVaVaVaVaVaVaVbzbzaVbebeawawawaVawawawawawbuahajaaaaaaaaaaaaaaaa
aaaabFbGbGbGbHawbIawawawawawawawawawbeawawawawawawawawaVaVaVawawawawawawawawawbeawawawawawawawawawawawawawawawawawawawawaVbzbzaVaVaVaVaVaVaVaVaVaVaVaVbzbzaVawawbeawawawawawawaVawbbahajaaaaaaaaaaaaaaaa
aaaaaaaaaaaaakawawawbJawawawawawbKbGbGbGbGbGbGbGbGbGbGbGbGbGbGbGbGbGbGbGbGbGbGbGbGbGbGbGbGbGbGbGbHbKbGbGbGbGbGbGbGbGbGbHaVaVaVaVaVaVbzaVaVaVaVaVaVaVaVaVaVbzbebfawbLawawawawawawawbbaMajaaaaaaaaaaaaaaaa
aaaaaaaaaaaaakawawawawawawawawawajaaaaaaaaaaaaaaaaaaaaaaaaaaaaaaaaaaaaaaaaaaaaaaaaaaaaaaaaaaaaaaakajaaaaaaaaaaaaaaaaaaakawawbeawaVawawawawawawawawawawawawawbebeawawawawawawbebeawawaWajaaaaaaaaaaaaaaaa
aaaaaaaaaaaaakbMawawawawawbKbGbGbNaaaaaaaaaaaaaaaaaaaaaaaaaaaaaaaaaaaaaaaaaaaaaaaaaaaaaaaaaaaaaaakajaaaaaaaaaaaaaaaaaaakbebObObeawawawawawawawawawawawawawawawawawbeawawawbeawawawawbKbNaaaaaaaaaaaaaaaa
aaaaaaaaaaaaakaObMawawawawajaaaaaaaaaaaaaaaaaaaaaaaaaaaaaaaaaaaaaaaaaaaaaaaaaaaaaaaaaaaaaaaaaaaaakajaaaaaaaaaaaaaaaaaaakbuagagbPbKbGbGbGbGbGbGbGbGbGbGbGbGbHawawawbzbQbzaVaVaVbebeawajaaaaaaaaaaaaaaaaaa
aaaaaaaaaaaaakaOawawawawawajaaaaaaaaaaaaaaaaaaaaaaaaaaaaaaaaaaaabRaaaabSaaaaaaaaaaaaaaaaaaaaaaaaakajaaaaaaaaaaaaaaaaaaakbTagagagajaaaaaaaaaaaaaaaaaaaaaaaaakawawbebzbzaVaVaVaVbebeawajaaaaaaaaaaaaaaaaaa
aaaaaaabacacadaOawawawawbbajaaaaaaaaaaaaaaaaaaaaaaaaaaaaaaabacacacacacacacacacacacacacacacacacacadaqacacacacacacacacacadagagagagajaaaaaaaaaabSaaaaaaaaaaaaakawawawaVaVaVbzbzbwbeawawajaaaaaaaaaaaaaaaaaa
aaaaaaakaeaeafaOawawawawbbaqacacbcaaaaaaaaaaaaaaaaaaaaaaaaakaiaiaiaiaiaiaiaiaiaiaiaiaiaiaiaiaiaiaCalaeaeaeaeaeaeaeaeaeafagbUagagajaaaaaaaaaaaaaaaaaaaaaaaaakawawawaVbzaVbzbzaVbeawawajaaaaaaaaaaaaaaaaaa
aaaaaaakaeaeafaOawawawawbbahaiaiajaaaaaaaaaaaaaaaaaaaaaaaaakaiaiaiaiaiaiaiaiaiaiaiaiaiaiaiaiaiaiaCalaeaeaeaeaeaeaeaeaeafbUbUbUagaqacacacacacacacbcaaaaaaaaakbVawawbWbWawawbeawawawawajaaaaaaaaaaaaaaaaaa
aaaaaaakaeaeafbXbMawawawbbahaiaiajaaaaaaaaaaaaaaaaaaaaaaaaakaiaiaBaiaiaiaiaiaBaiaiaiaiaiaBaiaiaiaCalaebYaeaeaebYaeaeaeafbUbUbUaSalaeaeaeaeaeaeaeajaaaaaaaaakagawbbagagaOawawawawawbbajaaaaaaaaaaaaaaaaaa
aaaaaaakaeaeafbXbMbeaVbMbZahaiaiajaaaaaaaaaaaaaaaaaaaaaaaaakaNaNaNaNaNaNaNaNaNaNaNaNaNaNaNaNaNaNbnamanananananananananapcabUbUcaamanananananananajaaaaaaaaakcbawbbagagaOawawawawawbuaqbcaaaaaaaaaaaaaaaa
aaaaaaakananapaObebeawbMbZaMaNaNajaaaaaaaaaaaaaaaaaaaaaaaaakcccdcdceatatatatatcecececeatatatatatatatatatatatceatcfatatauatatatatcgatatceatatceaWajaaaaaaaaakaSawbTagagaOavavavavbebbahajaaaaaaaaaaaaaaaa
aaaaaaakcccdaKawbeawawawawatatchajaabRaaaaaaaaaaaaaaaaaaaaakaObqbqawciawawawcjawawbeawawawckawawawawawclawawawawawawawawawawawawawawawawaPawbebuajaaaaaaaaakcmagagagagaOcnavavavawbbahajaaaaaaaaaaaaaaaa
acacacadaDawawawawaVaVawawaVawbbajaaaaaaaaaaaaaaaaaaaaaaaaakcoawawawawawawawawawawawawawawawawawcjawawawawawawawawawbebeawcpawawawawawciawawawbbajaaaaaaaaakagagagagagaOawawawawawbbahajaaaaaaaaaaaaaaaa
aeaeaeafaOawawawawaVaVawbebebebbaqacacacacacacacacacacacacadaObeawawawavavavavawawawcjawawawawawawawawawawawawawbebebeawbeawbeawawawawawawawawbbaqacacacacadcbagagaUatawawawawawawbbahajaaaaaaaaaaaaaaaa
aeaeaeafcqawawbebebeawawawbeawbbahaiaiaiaiaiaiaiaiaiaiaiaiaCcobeawawbDavavavavawawawawawawcrawawawawawawawcscjawawbebIawawctawawawawawawawawawbbalaeaeaeaeafagagatbzbzaVaVaVaVaVbebbahajaaaaaaaaaaaaaaaa
bYaeaeafbPbWcucvbObWbWbWaVawbebbahaiaiaiaiaiaiaiaiaiaiaiaiaCaObeawawawawawawbeawbxciawawawawawcwawawcxawawawawawawawawawbebeawawbeawawawawawawbbamcyanananapcbagbeaVaVaVaVaVaVaVbebuahajaaaaaaaaaaaaaaaa
aeaeaeafaRagaTaTagagagagaOawawbbahaiaBaiaiaiaiaiaiaBaiaiaiaCaOawcpawawawawbebeawbeawawawawawawawawawawawawawawawbxawbebebeawawawawawawawawawawbbaSayazazaAaSagagawbzaVaVaVaVaVcubWbTahajaaaaaaaaaaaaaaaa
anananapcacacacacacacaczcAcBbkboaMaNaNaNaNaNaNaNaNaNaNaNaNbncCblawawawbjbkbkcDcEcEcEcEcFbkbkcDcEcEcEcEcEcEcEcEcEcEcFbkbkbkbkbkbkbkbkblawawawawbbagcGaRagaTaTcbawawaVaVaVaVbzcHcIcacaaMajaaaaaaaaaaaaaaaa
agcJcJbUbUagagagagagagagawawawawagagagagagaSaSaSagagagagagagawawawawawawagagagagagagagagagagagaSaSagcGagagagagbUagagagagagagagagagagawawawawawawagagagagagawawawawaVaVaVaVaVcKcLayazaAajaaaaaaaaaaaaaaaa
cMcJcNcJcNbUcOagcOagcOagawawawawcOagcOagcOagcOagcOagcOagcOagcPcPcPcPcPcPcOagcOagcOagcOagcOagcOagcOagcOagcOagcOagcOagcOagcOagcOagcOagcPcPcPcPcPcPcOagcOagcOawcQawawaVaVaVaVcHcLcRagaTaTajaaaaaaaaaaaaaaaa
awawawcSbMaVawbxawawawawawawawawawawawawawawawawawawawawbeawawawawawawawawawawawawawawawawawawawawawawawbebeawawbMbMbMawawawawawawawawbIawawawawcTawawawawawawaVawbeawawawbbagagagagaSajaaaaaaaaaaaaaaaa
cUawawawawaVcVawawaVaVaVaVaVaVaVaVaVaVaVaVaVbxawawavavavavawawawawawaVaVaVaVaVaVaVaVaVaVaVbEaVaVaVaVawbeawawawawawawawawawawawawawbMawawawawawawcTawawbeawawawawawawawawawbbagagagagaSajaaaaaaaaaaaaaaaa
bMcWawawawaVawcVawaVaVaVaVaVaVaVaVaVaVaVaVaVawawbecXavavavawawawawawaVaVaVaVaVaVaVaVaVaVaVaVaVaVaVaVawawawawawawawawawawawawawawbMbMbMawawawawawcTawbeawaVawawawawawawaVawbbagagcYagagajaaaaaaaaaaaaaaaa
cSawcZcZcZdaaVawcVaVaVaVaVaVaVaVaVaVaVaVaVaVawawbebebeawawawawawawawaVaVaVaVaVaVaVaVaVaVaVaVaVaVaVaVawawawawaVaVaVaVaVaVaVaVaVawawbMawawawawawawcTawawawaVawawawaVawawawawbeaxagagagagajaaaaaaaaaaaaaaaa
cSawdbdbdbdbdcdbdbdcdcdcdcdcdcdcdcdcdcdcdcdcdbdbdbdbdbdbdbdbdbdbdbdbdcdcdcdcdcdcdcdcdcdcdcdcdcdcdcdcdbdbdbdbdcdcdcdcdcdcdcdcdcdbdbdbdbdbdbawawawcTawawawawawawaVawawawawbeawbbagagagagajaaaaaaaaaaaaaaaa
awcUawawawaVaVawawaVaVaVaVaVaVaVaVaVaVaVaVaVawawawawawawawawbMbMawawaVaVaVaVaVaVaVaVaVaVaVaVaVaVaVaVawawawawaVaVaVaVaVaVaVaVaVawawawawawawawawawcTawawawawawawawawawawawawawbTagagagbKbNaaaaaaaaaaaaaaaa
ddcSawawawaVaVawawaVaVaVaVaVaVaVaVaVaVaVaVaVawawawawawawawawbMawawawaVaVaVaVaVaVaVaVaVaVaVaVaVaVaVaVawawawbxawawawawawbeawawawawbeawawawawawawawcTawbeawawcwawbxawawawawawbbagagagagajaaaaaaaaaaaaaaaaaa
awawawawawaVawawawaVbwaVaVaVaVaVaVaVaVaVaVaVawawawawawawawawawawawawaVaVaVbEaVaVaVaVaVaVaVaVaVaVaVaVawawawawawawawawbeavavavavawbeawawawawawawawcTawawawawaVawawawawawaVawbTagagagagajaaaaaaaaaaaaaaaaaa
cUawawawawaVawawawawawawawawbIawawawawawawawawawawawawawawawawawawawawawawawawawawawawawawawawawawawawawawawawawbMbMawcnavavavbeawawawawawawawawcTawawawawawawawawbeawawbTaRagaTaTagajaaaaaaaaaaaaaaaaaa
bUbUdeagagagagagagagagagagagagagagagagagagagagagagagagagagagagagagagagagagagagagagagagagagagagagagagagagagagagagbUbUagagagagagagagagagagagagagagagawawawawawawawawawawawawagagcLcLagajaaaaaaaaaaaaaaaaaa
dfcJdgdhdidjdkdldmdldmdldmdldmdldmdldmdldmdldmdldmdldmdldmdldmdldmdldmdldmdldmdldmdldmdldmdldmdldmdldmdldmdndkdndkdndkdndkdndkdndkdndkdldmdldmdldmdodpdodpdodpdodpdodpdodpdldmdndkdnajaaaaaaaaaaaaaaaaaa
"}
