"aa" = (/turf/buildings/roof/r5,/area)
"ab" = (/turf/buildings/roof/r12,/area)
"ac" = (/turf/buildings/roof/r2,/area)
"ad" = (/turf/buildings/roof/r3,/area)
"ae" = (/turf/buildings/b5B,/area)
"af" = (/turf/buildings/b6B,/area)
"ag" = (/turf/grass,/area)
"ah" = (/turf/buildings/b4A,/area)
"ai" = (/turf/buildings/b5A,/area)
"aj" = (/turf/buildings/roof/r4,/area)
"ak" = (/turf/buildings/roof/r6,/area)
"al" = (/turf/buildings/b4B,/area)
"am" = (/turf/buildings/b1B,/area)
"an" = (/turf/buildings/b2B,/area)
"ao" = (/obj/markers/dense,/turf/buildings/b2B,/area)
"ap" = (/turf/buildings/b3B,/area)
"aq" = (/turf/buildings/roof,/area)
"ar" = (/turf/terrain/grass_edges/e6,/turf/terrain/trashbag,/turf/road,/area)
"as" = (/turf/terrain/grass_edges/e5,/turf/terrain/trashbag,/turf/road,/area)
"at" = (/turf/terrain/grass_edges/e5,/turf/road,/area)
"au" = (/turf/terrain/grass_edges/e5,/obj/barricade/barrel,/turf/road,/area)
"av" = (/obj/markers/dense,/turf/road,/area)
"aw" = (/turf/road,/area)
"ax" = (/turf/terrain/grass_edges/e7,/turf/road,/area)
"ay" = (/turf/terrain/hedge_l,/turf/grass,/area)
"az" = (/turf/terrain/hedge,/turf/grass,/area)
"aA" = (/turf/terrain/hedge_r,/turf/grass,/area)
"aB" = (/turf/buildings/b5A,/turf/buildings/details/long_window,/area)
"aC" = (/turf/buildings/b6A,/area)
"aD" = (/turf/terrain/grass_edges/e3,/turf/terrain/trashbag,/turf/road,/area)
"aE" = (/obj/item/gun/pink_dream,/turf/road,/area)
"aF" = (/obj/item/shield,/turf/road,/area)
"aG" = (/turf/terrain/trashbag,/turf/road,/area)
"aH" = (/turf/terrain/dumpster,/obj/markers/dense,/turf/road,/area)
"aI" = (/turf/terrain/grass_edges/e4,/turf/terrain/grass_edges/e4,/turf/road,/area)
"aJ" = (/turf/terrain/grass_edges/e6,/obj/markers/enemy_spawn,/turf/road,/area)
"aK" = (/turf/terrain/grass_edges/e5,/obj/markers/enemy_spawn,/turf/road,/area)
"aL" = (/turf/terrain/grass_edges/e7,/obj/markers/enemy_spawn,/turf/road,/area)
"aM" = (/turf/buildings,/area)
"aN" = (/turf/buildings/b2A,/area)
"aO" = (/turf/terrain/grass_edges/e3,/turf/road,/area)
"aP" = (/turf/terrain/sewer,/turf/road,/area)
"aQ" = (/turf/terrain/grass_edges/e4,/turf/terrain/trashbag,/turf/road,/area)
"aR" = (/turf/terrain/tree,/turf/grass,/area)
"aS" = (/obj/barricade/barrel,/turf/grass,/area)
"aT" = (/obj/markers/dense,/turf/grass,/area)
"aU" = (/turf/terrain/grass_edges/e6,/turf/road,/area)
"aV" = (/obj/markers/enemy_spawn,/turf/road,/area)
"aW" = (/turf/terrain/grass_edges/e7,/obj/barricade/barrel,/turf/road,/area)
"aX" = (/obj/hazard/spikes,/turf/terrain/grass_edges/e5,/turf/road,/area)
"aY" = (/obj/hazard/spikes,/obj/item/shield,/turf/terrain/grass_edges/e5,/turf/road,/area)
"aZ" = (/turf/terrain/grass_edges/e5,/turf/terrain/effects/firefly,/turf/road,/area)
"ba" = (/turf/terrain/grass_edges/e7,/turf/terrain/trashbag,/turf/road,/area)
"bb" = (/turf/terrain/grass_edges/e4,/turf/road,/area)
"bc" = (/turf/buildings/roof/r13,/area)
"bd" = (/obj/item/gun/edge_lord,/turf/grass,/area)
"be" = (/turf/terrain/details/grass_sprouts,/turf/road,/area)
"bf" = (/turf/terrain/details/grass_sprouts,/turf/terrain/details/grass_sprouts,/turf/road,/area)
"bg" = (/obj/hazard/portal,/turf/road,/area)
"bh" = (/obj/hazard/spikes,/turf/road,/area)
"bi" = (/obj/hazard/spikes,/obj/item/shield,/turf/road,/area)
"bj" = (/turf/terrain/chainlink/cl_left,/turf/road,/area)
"bk" = (/turf/terrain/chainlink,/turf/road,/area)
"bl" = (/turf/terrain/chainlink/cl_right,/turf/road,/area)
"bm" = (/obj/hazard/fire{layer = 4},/turf/buildings/b2A,/area)
"bn" = (/turf/buildings/b3A,/area)
"bo" = (/turf/terrain/chainlink,/turf/terrain/grass_edges/e4,/turf/road,/area)
"bp" = (/turf/terrain/trashbag,/turf/grass,/area)
"bq" = (/obj/barricade/barrel,/turf/road,/area)
"br" = (/turf/terrain/grass_edges/e5,/obj/hazard/fire,/turf/road,/area)
"bs" = (/turf/terrain/grass_edges/e5,/turf/terrain/trashbag,/obj/hazard/fire,/turf/road,/area)
"bt" = (/turf/terrain/grass_edges/e5,/obj/hazard/fire{layer = 4},/turf/road,/area)
"bu" = (/turf/terrain/grass_edges/e4,/turf/terrain/details/grass_sprouts,/turf/road,/area)
"bv" = (/turf/terrain/effects/firefly,/turf/road,/area)
"bw" = (/turf/terrain/dumpster,/turf/road,/area)
"bx" = (/turf/terrain/trashbag,/obj/hazard/fire,/turf/road,/area)
"by" = (/turf/terrain/obelisk,/turf/road,/area)
"bz" = (/turf/terrain/effects/cloud,/turf/road,/area)
"bA" = (/turf/buildings/roof/r10,/area)
"bB" = (/turf/buildings/roof/r8,/area)
"bC" = (/turf/buildings/roof/r9,/area)
"bD" = (/turf/terrain/helipad,/turf/road,/area)
"bE" = (/turf/buildings/roof/r7,/area)
"bF" = (/turf/terrain/pentagram,/obj/markers/enemy_spawn,/turf/road,/area)
"bG" = (/obj/barricade/crate,/turf/road,/area)
"bH" = (/turf/buildings/roof/r11,/area)
"bI" = (/turf/terrain/grass_edges/e2,/turf/terrain/details/grass_sprouts,/turf/road,/area)
"bJ" = (/turf/terrain/grass_edges/e8,/turf/road,/area)
"bK" = (/turf/terrain/effects/cloud,/turf/terrain/details/grass_sprouts,/turf/road,/area)
"bL" = (/turf/terrain/effects/cloud,/turf/buildings/roof/r5,/area)
"bM" = (/turf/terrain/billboard,/turf/buildings/roof/r5,/area)
"bN" = (/turf/terrain/grass_edges/e1,/turf/road,/area)
"bO" = (/obj/barricade/crate,/turf/grass,/area)
"bP" = (/turf/terrain/sidewalk/s9,/turf/grass,/area)
"bQ" = (/turf/terrain/grass_edges/e2,/turf/road,/area)
"bR" = (/obj/barricade/crate,/turf/terrain/grass_edges/e3,/turf/road,/area)
"bS" = (/turf/buildings/b5B,/turf/buildings/details/long_window,/area)
"bT" = (/obj/barricade/crate,/turf/terrain/grass_edges/e4,/turf/road,/area)
"bU" = (/turf/terrain/chainlink,/turf/grass,/area)
"bV" = (/turf/terrain/sidewalk/s6,/turf/grass,/area)
"bW" = (/obj/barricade/barrel,/turf/terrain/grass_edges/e6,/turf/road,/area)
"bX" = (/obj/barricade/barrel,/turf/terrain/grass_edges/e5,/turf/road,/area)
"bY" = (/turf/terrain/grass_edges/e5,/turf/terrain/details/grass_sprouts,/turf/road,/area)
"bZ" = (/turf/terrain/grass_edges/e5,/obj/item/health_pack,/turf/road,/area)
"ca" = (/obj/barricade/cone,/turf/terrain/grass_edges/e5,/turf/road,/area)
"cb" = (/obj/barricade/barrel,/turf/terrain/grass_edges/e7,/turf/road,/area)
"cc" = (/obj/item/revive_pack,/turf/road,/area)
"cd" = (/obj/markers/player_spawn,/turf/road,/area)
"ce" = (/obj/item/gun/kobra,/turf/road,/area)
"cf" = (/obj/item/special/molotov,/turf/road,/area)
"cg" = (/turf/terrain/sidewalk/s6,/obj/barricade/barrel,/turf/grass,/area)
"ch" = (/turf/terrain/crashed_car,/obj/markers/dense,/turf/road,/area)
"ci" = (/turf/terrain/grass_edges/e3,/turf/terrain/details/grass_sprouts,/turf/road,/area)
"cj" = (/obj/item/gun/ak66,/turf/road,/area)
"ck" = (/obj/item/health_pack,/turf/road,/area)
"cl" = (/obj/item/gun/krossbow,/turf/road,/area)
"cm" = (/turf/terrain/grass_edges/e3,/obj/item/strong_shield,/turf/road,/area)
"cn" = (/turf/terrain/grass_edges/e2,/obj/markers/enemy_spawn,/turf/road,/area)
"co" = (/turf/terrain/grass_edges/e2,/turf/terrain/pentagram,/turf/road,/area)
"cp" = (/turf/terrain/pentagram,/turf/road,/area)
"cq" = (/turf/buildings/b2B,/turf/buildings/details/long_window,/area)
"cr" = (/turf/terrain/chainlink/cl_right,/obj/hazard/spikes,/turf/grass,/area)
"cs" = (/turf/terrain/grass_edges/e3,/obj/hazard/spikes,/turf/road,/area)
"ct" = (/turf/terrain/chainlink/cl_left,/obj/hazard/spikes,/turf/road,/area)
"cu" = (/turf/terrain/chainlink,/turf/terrain/grass_edges/e3,/turf/road,/area)
"cv" = (/turf/terrain/hedge_l,/turf/dirt,/area)
"cw" = (/turf/terrain/hedge,/turf/dirt,/area)
"cx" = (/turf/terrain/hedge_r,/turf/dirt,/area)
"cy" = (/turf/terrain/effects/firefly,/turf/grass,/area)
"cz" = (/turf/terrain/chainlink/cl_left,/turf/grass,/area)
"cA" = (/obj/barricade/cone,/turf/grass,/area)
"cB" = (/turf/terrain/sidewalk/s3,/obj/hazard/fire,/turf/grass,/area)
"cC" = (/turf/terrain/sidewalk/s3,/obj/barricade/crate,/turf/grass,/area)
"cD" = (/turf/terrain/sidewalk/s3,/turf/grass,/area)
"cE" = (/turf/terrain/crosswalk/c2,/turf/road,/area)
"cF" = (/turf/terrain/sidewalk/s4,/turf/road,/area)
"cG" = (/obj/hazard/fire,/turf/road,/area)
"cH" = (/turf/terrain/crosswalk,/turf/road,/area)
"cI" = (/turf/terrain/crashed_car,/turf/road,/area)
"cJ" = (/obj/gore/blood,/turf/road,/area)
"cK" = (/turf/terrain/car,/turf/road,/area)
"cL" = (/turf/terrain/car,/obj/markers/dense,/turf/road,/area)
"cM" = (/obj/hazard/portal,/turf/grass,/area)
"cN" = (/obj/barricade/cone,/turf/road,/area)
"cO" = (/obj/markers/enemy_spawn,/obj/markers/enemy_spawn,/turf/road,/area)
"cP" = (/turf/terrain/roadline,/turf/road,/area)
"cQ" = (/turf/terrain/roadline,/obj/markers/enemy_spawn,/turf/road,/area)
"cR" = (/turf/terrain/car,/obj/hazard/fire,/turf/road,/area)
"cS" = (/turf/terrain/car,/obj/hazard/fire,/turf/grass,/area)
"cT" = (/obj/markers/enemy_spawn,/turf/grass,/area)
"cU" = (/turf/terrain/sidewalk/s8,/obj/hazard/fire,/turf/grass,/area)
"cV" = (/turf/terrain/sidewalk/s8,/obj/barricade/cone,/turf/grass,/area)
"cW" = (/obj/barricade/cone,/obj/overlays/chainlink{name = "chainlink pixel down"; pixel_y = -16},/turf/grass,/area)
"cX" = (/turf/terrain/sidewalk/s8,/obj/barricade/cone,/obj/overlays/chainlink{name = "chainlink pixel down"; pixel_y = -16},/turf/grass,/area)
"cY" = (/obj/barricade/crate,/obj/overlays/chainlink{name = "chainlink pixel down"; pixel_y = -16},/turf/grass,/area)
"cZ" = (/turf/terrain/sidewalk/s8,/obj/overlays/chainlink{name = "chainlink pixel down"; pixel_y = -16},/turf/grass,/area)
"da" = (/obj/markers/enemy_spawn,/obj/overlays/chainlink{name = "chainlink pixel down"; pixel_y = -16},/turf/grass,/area)
"db" = (/turf/terrain/sidewalk/s8,/obj/markers/enemy_spawn,/obj/overlays/chainlink{name = "chainlink pixel down"; pixel_y = -16},/turf/grass,/area)
"dc" = (/obj/overlays/chainlink{name = "chainlink pixel down"; pixel_y = -16},/turf/grass,/area)
"dd" = (/obj/markers/enemy_spawn,/obj/overlays/chainlink{name = "chainlink pixel down"; pixel_y = -16},/turf/road,/area)
"de" = (/turf/terrain/sidewalk/s8,/obj/markers/enemy_spawn,/obj/overlays/chainlink{name = "chainlink pixel down"; pixel_y = -16},/turf/road,/area)

(1,1,1) = {"
aaaaabacadaeaeaeaeaeaeaeafagagagagagahaiaiaiaiaiaiaiaiaiaiaiaiaiaiaiaiaiaiaiaiaiaiaiaiaiaiaiaiaiaiaiaiaiaiaiaiaiajaaaaaaaaaaaaaaaaaaaaaaaaaaaaaaaaaaaaaaakalaeaeaeaeaeaeaeaeaeaeaeafajaaaaaaaaaaaaaaaaaa
aaaaakaeafaeaeaeaeaeaeaeafagagagagagahaiaiaiaiaiaiaiaiaiaiaiaiaiaiaiaiaiaiaiaiaiaiaiaiaiaiaiaiaiaiaiaiaiaiaiaiaiajaaaaaaaaaaaaaaaaaaaaaaaaaaaaaaaaaaaaaaakamanananananananananaoaoapajaaaaaaaaaaaaaaaaaa
aaaaakaeafaeaeaeaeaeaeaeafagagagagagahaiaiaiaiaiaiaiaiaiaiaiaiaiaiaiaiaiaiaiaiaiaiaiaiaiaiaiaiaiaiaiaiaiaiaiaiaiaqacacacacacacacacacacacacacacacacacacacadarasatatauauasasatavavawaxajaaaaaaaaaaaaaaaaaa
aaaaakaeafaeaeaeaeaeaeaeafayazazazaAahaiaiaiaiaiaiaiaBaiaiaiaiaiaiaiaiaiaiaBaiaiaiaiaiaiaiaiaiaiaBaiaiaiaiaiaiaiahaiaiaiaiaiaiaiaiaiaiaiaiaiaiaiaiaiaiaiaCaDaEawawawawawaFaGaHavavaIajaaaaaaaaaaaaaaaaaa
aaaaakaeafanananananananapaJaKaKaKaLaMaNaNaNaNaNaNaNaNaNaNaNaNaNaNaNaNaNaNaNaNaNaNaNaNaNaNaNaNaNaNaNaNaNaNaNaNaNahaBaiaiaiaiaiaBaiaiaiaiaiaBaiaiaiaiaiaiaCaOaPawawawawawawawawawawaQajaaaaaaaaaaaaaaaaaa
aaaaakanapaRaSaTaTagaUataKaVawaVaVaVataWayazaAaUataXaXaXaXaYaXaXaXaXaZatatatatatatatatatatatatatatatatatatatatbaahaiaiaiaiaiaiaiaiaiaiaiaiaiaiaiaiaiaiaiaCaOawawawaFawawawawawawaGbbaqbcaaaaaaaaaaaaaaaa
aaaaakagbdagaUauatatawawawawbebfbeawawawatatatawawawawawawawawawawawawawawawbgawawawawbhbhbhbhbibhbhbhbhawawawbbahaiaiaiaBaiaiaiaiaiaBaiaiaiaiaiaBaiaiaiaCaOawbebeawawawawawawaGaGbbahajaaaaaaaaaaaaaaaa
aaaaakagagaUawawawawawawawawawbebeawawawawawawawbjbkbkbkbkbkbkbkbkbkbkbkbkbkbkbkbkbkbkbkbkbkbkbkbkbkbkbkblawawbbaMaNaNaNbmbmaNaNbmbmaNaNaNaNaNaNaNaNaNaNbnaOawawbebjbkbkbkbkbkbkbkboahajaaaaaaaaaaaaaaaa
aaaaakbpagaOawawawawawawawawawawbebeawawawawawawawawawawbebeawawawawawawawawbqawawawbqbqawawawawawawawawawawawawatatasbratatatbsatbtatatasatatatatatatatatawbeawawawawawaVawbebebebuahajaaaaaaaaaaaaaaaa
aaaaakaSbpaOaPawawawbvawawawawawawawawavavavavawawbvawawawawawawawavavavavawawawbqawawawbeawawawavavavavawawawawawawbqaGbwawawbxbwawawaGawawawawawawawawawbeawawaVawawawawawawawbebuahajaaaaaaaaaaaaaaaa
aaaaakagagaOawawawawawawawawawawawawbyavavavavawawawawawawawawawbyavavavavawawawawawawbeawawawbyavavavavawbzawawawawawbqawawaGaGawawaGawawbeawawawawawbvbebeawawawawawaVaVawawaVawbbahajaaaaaaaaaaaaaaaa
aaaaakagagaOawawawawawawawawawawawawawawawawawawbebeawbeawawawawawawawawawawawawawbeawbebeawbvawawawbqawawawawawawawawawbeawawawawawawawawawawawawawawbebeawbebeawawawaVawawawawawbuahajaaaaaaaaaaaaaaaa
aaaabAbBbBbBbCawbzawawawawawawawawawbeawawawawawawawawaVaVaVawawawawawawawawawbeawawawawawawawawawawawawawawawawawawawawawbebeawawawawawawawawawawawawbebeawawawbeawawawawawawaVawbbahajaaaaaaaaaaaaaaaa
aaaaaaaaaaaaakawawawbDawawawawawbEbBbBbBbBbBbBbBbBbBbBbBbBbBbBbBbBbBbBbBbBbBbBbBbBbBbBbBbBbBbBbBbCbEbBbBbBbBbBbBbBbBbBbCawawawawawawbeawawawawawawawawawawbebebfawbFawawawawawawawbbaMajaaaaaaaaaaaaaaaa
aaaaaaaaaaaaakawawawawawawawawawajaaaaaaaaaaaaaaaaaaaaaaaaaaaaaaaaaaaaaaaaaaaaaaaaaaaaaaaaaaaaaaakajaaaaaaaaaaaaaaaaaaakawawbeawaVawawawawawawawawawawawawawbebeawawawawawawbebeawawaWajaaaaaaaaaaaaaaaa
aaaaaaaaaaaaakbGawawawawawbEbBbBbHaaaaaaaaaaaaaaaaaaaaaaaaaaaaaaaaaaaaaaaaaaaaaaaaaaaaaaaaaaaaaaakajaaaaaaaaaaaaaaaaaaakbebIbIbeawawawawawawawawawawawawawawawawawbeawawawbeawawawawbEbHaaaaaaaaaaaaaaaa
aaaaaaaaaaaaakaObGawawawawajaaaaaaaaaaaaaaaaaaaaaaaaaaaaaaaaaaaaaaaaaaaaaaaaaaaaaaaaaaaaaaaaaaaaakajaaaaaaaaaaaaaaaaaaakbuagagbJbEbBbBbBbBbBbBbBbBbBbBbBbBbCawawawbebKbeawawawbebeawajaaaaaaaaaaaaaaaaaa
aaaaaaaaaaaaakaOawawawawawajaaaaaaaaaaaaaaaaaaaaaaaaaaaaaaaaaaaabLaaaabMaaaaaaaaaaaaaaaaaaaaaaaaakajaaaaaaaaaaaaaaaaaaakbNagagagajaaaaaaaaaaaaaaaaaaaaaaaaakawawbebebeawawawawbebeawajaaaaaaaaaaaaaaaaaa
aaaaaaabacacadaOawawawawbbajaaaaaaaaaaaaaaaaaaaaaaaaaaaaaaabacacacacacacacacacacacacacacacacacacadaqacacacacacacacacacadagagagagajaaaaaaaaaabMaaaaaaaaaaaaakawawawawawawbebebvbeawawajaaaaaaaaaaaaaaaaaa
aaaaaaakaeaeafaOawawawawbbaqacacbcaaaaaaaaaaaaaaaaaaaaaaaaakaiaiaiaiaiaiaiaiaiaiaiaiaiaiaiaiaiaiaCalaeaeaeaeaeaeaeaeaeafagbOagagajaaaaaaaaaaaaaaaaaaaaaaaaakawawawawbeawbebeawbeawawajaaaaaaaaaaaaaaaaaa
aaaaaaakaeaeafaOawawawawbbahaiaiajaaaaaaaaaaaaaaaaaaaaaaaaakaiaiaiaiaiaiaiaiaiaiaiaiaiaiaiaiaiaiaCalaeaeaeaeaeaeaeaeaeafbObObOagaqacacacacacacacbcaaaaaaaaakbPawawbQbQawawbeawawawawajaaaaaaaaaaaaaaaaaa
aaaaaaakaeaeafbRbGawawawbbahaiaiajaaaaaaaaaaaaaaaaaaaaaaaaakaiaiaBaiaiaiaiaiaBaiaiaiaiaiaBaiaiaiaCalaebSaeaeaebSaeaeaeafbObObOaSalaeaeaeaeaeaeaeajaaaaaaaaakagawbbagagaOawawawawawbbajaaaaaaaaaaaaaaaaaa
aaaaaaakaeaeafbRbGbeaVbGbTahaiaiajaaaaaaaaaaaaaaaaaaaaaaaaakaNaNaNaNaNaNaNaNaNaNaNaNaNaNaNaNaNaNbnamanananananananananapbUbObObUamanananananananajaaaaaaaaakbVawbbagagaOawawawawawbuaqbcaaaaaaaaaaaaaaaa
aaaaaaakananapaObebeawbGbTaMaNaNajaaaaaaaaaaaaaaaaaaaaaaaaakbWbXbXbYatatatatatbYbYbYbYatatatatatatatatatatatbYatbZatatauatatatatcaatatbYatatbYaWajaaaaaaaaakaSawbNagagaOavavavavbebbahajaaaaaaaaaaaaaaaa
aaaaaaakbWbXaKawbeawawawawatatcbajaabLaaaaaaaaaaaaaaaaaaaaakaObqbqawccawawawcdawawbeawawawceawawawawawcfawawawawawawawawawawawawawawawawaPawbebuajaaaaaaaaakcgagagagagaOchavavavawbbahajaaaaaaaaaaaaaaaa
acacacadaDawawawawaVaVawawaVawbbajaaaaaaaaaaaaaaaaaaaaaaaaakciawawawawawawawawawawawawawawawawawcdawawawawcjawawawawbebeawckawawawawawawawawawbbajaaaaaaaaakagagagagagaOawawawawawbbahajaaaaaaaaaaaaaaaa
aeaeaeafaOawawawawaVaVawbebebebbaqacacacacacacacacacacacacadaObeawawawavavavavawawawcdawawawawawawawawawawawawawbebebeclbeawbeawawawawawawawawbbaqacacacacadbVagagaUatawawawawawawbbahajaaaaaaaaaaaaaaaa
aeaeaeafcmawawbebebeawawawbeawbbahaiaiaiaiaiaiaiaiaiaiaiaiaCcibeawawbyavavavavawawawawawawawawawawawawawawawcdawawbebzawawbeawawawawawawawawawbbalaeaeaeaeafagagatbebeawawawawawbebbahajaaaaaaaaaaaaaaaa
bSaeaeafbJbQcncobIbQbQbQaVawbebbahaiaiaiaiaiaiaiaiaiaiaiaiaCaObeawawawawawawbeawbvawawawawawawcpawawawawawawawawawawawawbebeawawbeawawawawawawbbamcqanananapbVagbeawawawawawawawbebuahajaaaaaaaaaaaaaaaa
aeaeaeafaRagaTaTagagagagaOawawbbahaiaBaiaiaiaiaiaiaBaiaiaiaCaOawckawawawawbebeawbeawawawawawawawawawawawawawawawbvawbebebeawawawawawawawawawawbbaSayazazaAaSagagawbeawawawawawbQbQbNahajaaaaaaaaaaaaaaaa
anananapbUbUbUbUbUbUbUcrcsctbkboaMaNaNaNaNaNaNaNaNaNaNaNaNbncublawawawbjbkbkcvcwcwcwcwcxbkbkcvcwcwcwcwcwcwcwcwcwcwcxbkbkbkbkbkbkbkbkblawawawawbbagcyaRagaTaTbVawawawawawawbebbczbUbUaMajaaaaaaaaaaaaaaaa
agcAcAbObOagagagagagagagawawawawagagagagagaSaSaSagagagagagagawawawawawawagagagagagagagagagagagaSaSagcyagagagagbOagagagagagagagagagagawawawawawawagagagagagawawawawawawawawawbNagayazaAajaaaaaaaaaaaaaaaa
cBcAcCcAcCbOcDagcDagcDagawawawawcDagcDagcDagcDagcDagcDagcDagcEcEcEcEcEcEcDagcDagcDagcDagcDagcDagcDagcDagcDagcDagcDagcDagcDagcDagcDagcEcEcEcEcEcEcDagcDagcDawcFawawawawawawbbagaRagaTaTajaaaaaaaaaaaaaaaa
awawawcGbGaVawbvawawawawawawawawawawawawawawawawawawawawbeawawawawawawawawawawawawawawawawawawawawawawawbebeawawbGbGbGawawawawawawawawbzawawawawcHawawawawawawaVawbeawawawbbagagagagaSajaaaaaaaaaaaaaaaa
cIawawawawaVcJawawawawawawawawawawawawawawawbvawawavavavavawawawawawawawawawawawawawawawawbzawawawawawbeawawawawawawawawawawawawawbGawawawawawawcHawawbeawawawawawawawawawbbagagagagaSajaaaaaaaaaaaaaaaa
bGcKawawawaVawcJawawawawawawawawawawawawawawawawbecLavavavawawawawawawawawawawawawawawawawawawawawawawawawawawawawawawawawawawawbGbGbGawawawawawcHawbeawaVawawawawawawaVawbbagagcMagagajaaaaaaaaaaaaaaaa
cGawcNcNcNcOaVawcJawawawawawawawawawawawawawawawbebebeawawawawawawawawawawawawawawawawawawawawawawawawawawawawawawawawawawawawawawbGawawawawawawcHawawawaVawawawaVawawawawbeaxagagagagajaaaaaaaaaaaaaaaa
cGawcPcPcPcPcQcPcPcPcPcPcPcPcPcPcPcPcPcPcPcPcPcPcPcPcPcPcPcPcPcPcPcPcPcPcPcPcPcPcPcPcPcPcPcPcPcPcPcPcPcPcPcPcPcPcPcPcPcPcPcPcPcPcPcPcPcPcPawawawcHawawawawawawaVawawawawbeawbbagagagagajaaaaaaaaaaaaaaaa
awcIawawawaVaVawawawawawawawawawawawawawawawawawawawawawawawbGbGawawawawawawawawawawawawawawawawawawawawawawawawawawawawawawawawawawawawawawawawcHawawawawawawawawawawawawawbNagagagbEbHaaaaaaaaaaaaaaaa
cRcGawawawaVaVawawawawawawawawawawawawawawawawawawawawawawawbGawawawawawawawawawawawawawawawawawawawawawawbvawawawawawbeawawawawbeawawawawawawawcHawbeawawcpawbvawawawawawbbagagagagajaaaaaaaaaaaaaaaaaa
awawawawawaVawawawawbvawawawawawawawawawawawawawawawawawawawawawawawawawawbzawawawawawawawawawawawawawawawawawawawawbeavavavavawbeawawawawawawawcHawawawawaVawawawawawaVawbNagagagagajaaaaaaaaaaaaaaaaaa
cIawawawawaVawawawawawawawawbzawawawawawawawawawawawawawawawawawawawawawawawawawawawawawawawawawawawawawawawawawbGbGawchavavavbeawawawawawawawawcHawawawawawawawawbeawawbNaRagaTaTagajaaaaaaaaaaaaaaaaaa
bObOcSagagagagagagagagagagagagagagagagagagagagagagagagagagagagagagagagagagagagagagagagagagagagagagagagagagagagagbObOagagagagagagagagagagagagagagagawawawawawawawawawawawawagagcTcTagajaaaaaaaaaaaaaaaaaa
cUcAcVcWcXcYcZdadbdadbdadbdadbdadbdadbdadbdadbdadbdadbdadbdadbdadbdadbdadbdadbdadbdadbdadbdadbdadbdadbdadbdccZdccZdccZdccZdccZdccZdccZdadbdadbdadbdddedddedddedddedddedddedadbdccZdcajaaaaaaaaaaaaaaaaaa
"}
