"aa" = (/turf/buildings/roof/r5,/area)
"ab" = (/turf/buildings/roof/r12,/area)
"ac" = (/turf/buildings/roof/r2,/area)
"ad" = (/turf/buildings/roof/r3,/area)
"ae" = (/turf/buildings/b5B,/area)
"af" = (/turf/buildings/b6B,/area)
"ag" = (/turf/grass,/area)
"ah" = (/turf/buildings/b4A,/area)
"ai" = (/turf/buildings/b5A,/area)
"aj" = (/turf/buildings/roof/r4,/area)
"ak" = (/turf/buildings/roof/r6,/area)
"al" = (/turf/buildings/b4B,/area)
"am" = (/turf/buildings/b1B,/area)
"an" = (/turf/buildings/b2B,/area)
"ao" = (/obj/markers/dense,/turf/buildings/b2B,/area)
"ap" = (/turf/buildings/b3B,/area)
"aq" = (/turf/buildings/roof,/area)
"ar" = (/turf/terrain/grass_edges/e6,/turf/terrain/trashbag,/turf/road,/area)
"as" = (/turf/terrain/grass_edges/e5,/turf/terrain/trashbag,/turf/road,/area)
"at" = (/turf/terrain/grass_edges/e5,/turf/road,/area)
"au" = (/turf/terrain/grass_edges/e5,/obj/barricade/barrel,/turf/road,/area)
"av" = (/obj/markers/dense,/turf/road,/area)
"aw" = (/turf/road,/area)
"ax" = (/turf/terrain/grass_edges/e7,/turf/road,/area)
"ay" = (/turf/terrain/hedge_l,/turf/grass,/area)
"az" = (/turf/terrain/hedge,/turf/grass,/area)
"aA" = (/turf/terrain/hedge_r,/turf/grass,/area)
"aB" = (/turf/buildings/b6A,/area)
"aC" = (/turf/terrain/grass_edges/e3,/turf/terrain/trashbag,/turf/road,/area)
"aD" = (/obj/item/gun/pink_dream,/turf/road,/area)
"aE" = (/obj/item/shield,/turf/road,/area)
"aF" = (/turf/terrain/trashbag,/turf/road,/area)
"aG" = (/turf/terrain/dumpster,/obj/markers/dense,/turf/road,/area)
"aH" = (/turf/terrain/grass_edges/e4,/turf/terrain/grass_edges/e4,/turf/road,/area)
"aI" = (/turf/terrain/grass_edges/e6,/obj/markers/enemy_spawn,/turf/road,/area)
"aJ" = (/turf/terrain/grass_edges/e5,/obj/markers/enemy_spawn,/turf/road,/area)
"aK" = (/turf/terrain/grass_edges/e7,/obj/markers/enemy_spawn,/turf/road,/area)
"aL" = (/turf/buildings,/area)
"aM" = (/turf/buildings/b2A,/area)
"aN" = (/turf/terrain/grass_edges/e3,/turf/road,/area)
"aO" = (/turf/terrain/sewer,/turf/road,/area)
"aP" = (/turf/terrain/grass_edges/e4,/turf/terrain/trashbag,/turf/road,/area)
"aQ" = (/turf/terrain/tree,/turf/grass,/area)
"aR" = (/obj/barricade/barrel,/turf/grass,/area)
"aS" = (/obj/markers/dense,/turf/grass,/area)
"aT" = (/turf/terrain/grass_edges/e6,/turf/road,/area)
"aU" = (/obj/markers/enemy_spawn,/turf/road,/area)
"aV" = (/turf/terrain/grass_edges/e7,/obj/barricade/barrel,/turf/road,/area)
"aW" = (/obj/hazard/spikes,/turf/terrain/grass_edges/e5,/turf/road,/area)
"aX" = (/obj/hazard/spikes,/obj/item/shield,/turf/terrain/grass_edges/e5,/turf/road,/area)
"aY" = (/turf/terrain/grass_edges/e5,/turf/terrain/effects/firefly,/turf/road,/area)
"aZ" = (/turf/terrain/grass_edges/e7,/turf/terrain/trashbag,/turf/road,/area)
"ba" = (/turf/terrain/grass_edges/e4,/turf/road,/area)
"bb" = (/turf/buildings/roof/r13,/area)
"bc" = (/obj/item/gun/edge_lord,/turf/grass,/area)
"bd" = (/turf/terrain/details/grass_sprouts,/turf/road,/area)
"be" = (/turf/terrain/details/grass_sprouts,/turf/terrain/details/grass_sprouts,/turf/road,/area)
"bf" = (/obj/hazard/portal,/turf/road,/area)
"bg" = (/obj/hazard/spikes,/turf/road,/area)
"bh" = (/obj/hazard/spikes,/obj/item/shield,/turf/road,/area)
"bi" = (/turf/terrain/chainlink/cl_left,/turf/road,/area)
"bj" = (/turf/terrain/chainlink,/turf/road,/area)
"bk" = (/turf/terrain/chainlink/cl_right,/turf/road,/area)
"bl" = (/obj/hazard/fire{layer = 4},/turf/buildings/b2A,/area)
"bm" = (/turf/buildings/b3A,/area)
"bn" = (/turf/terrain/chainlink,/turf/terrain/grass_edges/e4,/turf/road,/area)
"bo" = (/turf/terrain/trashbag,/turf/grass,/area)
"bp" = (/obj/barricade/barrel,/turf/road,/area)
"bq" = (/turf/terrain/grass_edges/e5,/obj/hazard/fire,/turf/road,/area)
"br" = (/turf/terrain/grass_edges/e5,/turf/terrain/trashbag,/obj/hazard/fire,/turf/road,/area)
"bs" = (/turf/terrain/grass_edges/e5,/obj/hazard/fire{layer = 4},/turf/road,/area)
"bt" = (/turf/terrain/grass_edges/e4,/turf/terrain/details/grass_sprouts,/turf/road,/area)
"bu" = (/turf/terrain/effects/firefly,/turf/road,/area)
"bv" = (/turf/terrain/dumpster,/turf/road,/area)
"bw" = (/turf/terrain/trashbag,/obj/hazard/fire,/turf/road,/area)
"bx" = (/turf/terrain/obelisk,/turf/road,/area)
"by" = (/turf/terrain/effects/cloud,/turf/road,/area)
"bz" = (/turf/buildings/roof/r10,/area)
"bA" = (/turf/buildings/roof/r8,/area)
"bB" = (/turf/buildings/roof/r9,/area)
"bC" = (/turf/terrain/helipad,/turf/road,/area)
"bD" = (/turf/buildings/roof/r7,/area)
"bE" = (/turf/terrain/pentagram,/obj/markers/enemy_spawn,/turf/road,/area)
"bF" = (/obj/barricade/crate,/turf/road,/area)
"bG" = (/turf/buildings/roof/r11,/area)
"bH" = (/turf/terrain/grass_edges/e2,/turf/terrain/details/grass_sprouts,/turf/road,/area)
"bI" = (/turf/terrain/grass_edges/e8,/turf/road,/area)
"bJ" = (/turf/terrain/effects/cloud,/turf/terrain/details/grass_sprouts,/turf/road,/area)
"bK" = (/turf/terrain/effects/cloud,/turf/buildings/roof/r5,/area)
"bL" = (/turf/terrain/billboard,/turf/buildings/roof/r5,/area)
"bM" = (/turf/terrain/grass_edges/e1,/turf/road,/area)
"bN" = (/obj/barricade/crate,/turf/grass,/area)
"bO" = (/turf/terrain/sidewalk/s9,/turf/grass,/area)
"bP" = (/turf/terrain/grass_edges/e2,/turf/road,/area)
"bQ" = (/obj/barricade/crate,/turf/terrain/grass_edges/e3,/turf/road,/area)
"bR" = (/obj/barricade/crate,/turf/terrain/grass_edges/e4,/turf/road,/area)
"bS" = (/turf/terrain/chainlink,/turf/grass,/area)
"bT" = (/turf/terrain/sidewalk/s6,/turf/grass,/area)
"bU" = (/obj/barricade/barrel,/turf/terrain/grass_edges/e6,/turf/road,/area)
"bV" = (/obj/barricade/barrel,/turf/terrain/grass_edges/e5,/turf/road,/area)
"bW" = (/turf/terrain/grass_edges/e5,/turf/terrain/details/grass_sprouts,/turf/road,/area)
"bX" = (/turf/terrain/grass_edges/e5,/obj/item/health_pack,/turf/road,/area)
"bY" = (/obj/barricade/cone,/turf/terrain/grass_edges/e5,/turf/road,/area)
"bZ" = (/obj/barricade/barrel,/turf/terrain/grass_edges/e7,/turf/road,/area)
"ca" = (/obj/item/revive_pack,/turf/road,/area)
"cb" = (/obj/markers/player_spawn,/turf/road,/area)
"cc" = (/obj/item/gun/kobra,/turf/road,/area)
"cd" = (/obj/item/special/molotov,/turf/road,/area)
"ce" = (/turf/terrain/sidewalk/s6,/obj/barricade/barrel,/turf/grass,/area)
"cf" = (/turf/terrain/grass_edges/e3,/turf/terrain/details/grass_sprouts,/turf/road,/area)
"cg" = (/obj/item/gun/ak66,/turf/road,/area)
"ch" = (/obj/item/health_pack,/turf/road,/area)
"ci" = (/obj/item/gun/krossbow,/turf/road,/area)
"cj" = (/turf/terrain/grass_edges/e3,/obj/item/strong_shield,/turf/road,/area)
"ck" = (/turf/terrain/grass_edges/e2,/obj/markers/enemy_spawn,/turf/road,/area)
"cl" = (/turf/terrain/grass_edges/e2,/turf/terrain/pentagram,/turf/road,/area)
"cm" = (/turf/terrain/pentagram,/turf/road,/area)
"cn" = (/turf/terrain/chainlink/cl_right,/obj/hazard/spikes,/turf/grass,/area)
"co" = (/turf/terrain/grass_edges/e3,/obj/hazard/spikes,/turf/road,/area)
"cp" = (/turf/terrain/chainlink/cl_left,/obj/hazard/spikes,/turf/road,/area)
"cq" = (/turf/terrain/chainlink,/turf/terrain/grass_edges/e3,/turf/road,/area)
"cr" = (/turf/terrain/hedge_l,/turf/dirt,/area)
"cs" = (/turf/terrain/hedge,/turf/dirt,/area)
"ct" = (/turf/terrain/hedge_r,/turf/dirt,/area)
"cu" = (/turf/terrain/effects/firefly,/turf/grass,/area)
"cv" = (/turf/terrain/chainlink/cl_left,/turf/grass,/area)
"cw" = (/obj/barricade/cone,/turf/grass,/area)
"cx" = (/turf/terrain/sidewalk/s3,/obj/hazard/fire,/turf/grass,/area)
"cy" = (/turf/terrain/sidewalk/s3,/obj/barricade/crate,/turf/grass,/area)
"cz" = (/turf/terrain/sidewalk/s3,/turf/grass,/area)
"cA" = (/turf/terrain/crosswalk/c2,/turf/road,/area)
"cB" = (/turf/terrain/sidewalk/s4,/turf/road,/area)
"cC" = (/obj/hazard/fire,/turf/road,/area)
"cD" = (/turf/terrain/crosswalk,/turf/road,/area)
"cE" = (/turf/terrain/crashed_car,/turf/road,/area)
"cF" = (/obj/gore/blood,/turf/road,/area)
"cG" = (/turf/terrain/car,/turf/road,/area)
"cH" = (/turf/terrain/car,/obj/markers/dense,/turf/road,/area)
"cI" = (/obj/hazard/portal,/turf/grass,/area)
"cJ" = (/obj/barricade/cone,/turf/road,/area)
"cK" = (/obj/markers/enemy_spawn,/obj/markers/enemy_spawn,/turf/road,/area)
"cL" = (/turf/terrain/roadline,/turf/road,/area)
"cM" = (/turf/terrain/roadline,/obj/markers/enemy_spawn,/turf/road,/area)
"cN" = (/turf/terrain/car,/obj/hazard/fire,/turf/road,/area)
"cO" = (/turf/terrain/crashed_car,/obj/markers/dense,/turf/road,/area)
"cP" = (/turf/terrain/car,/obj/hazard/fire,/turf/grass,/area)
"cQ" = (/turf/terrain/sidewalk/s8,/obj/hazard/fire,/turf/grass,/area)
"cR" = (/turf/terrain/sidewalk/s8,/obj/barricade/cone,/turf/grass,/area)
"cS" = (/turf/terrain/sidewalk/s8,/turf/grass,/area)
"cT" = (/obj/markers/enemy_spawn,/turf/grass,/area)
"cU" = (/turf/terrain/sidewalk/s8,/obj/markers/enemy_spawn,/turf/grass,/area)
"cV" = (/turf/terrain/sidewalk/s8,/obj/markers/enemy_spawn,/turf/road,/area)

(1,1,1) = {"
aaaaabacadaeaeaeaeaeaeaeafagagagagagahaiaiaiaiaiaiaiaiaiaiaiaiaiaiaiaiaiaiaiaiaiaiaiaiaiaiaiaiaiaiaiaiaiaiaiaiaiajaaaaaaaaaaaaaaaaaaaaaaaaaaaaaaaaaaaaaaakalaeaeaeaeaeaeaeaeaeaeaeafajaaaaaaaaaaaaaaaaaa
aaaaakaeafaeaeaeaeaeaeaeafagagagagagahaiaiaiaiaiaiaiaiaiaiaiaiaiaiaiaiaiaiaiaiaiaiaiaiaiaiaiaiaiaiaiaiaiaiaiaiaiajaaaaaaaaaaaaaaaaaaaaaaaaaaaaaaaaaaaaaaakamanananananananananaoaoapajaaaaaaaaaaaaaaaaaa
aaaaakaeafaeaeaeaeaeaeaeafagagagagagahaiaiaiaiaiaiaiaiaiaiaiaiaiaiaiaiaiaiaiaiaiaiaiaiaiaiaiaiaiaiaiaiaiaiaiaiaiaqacacacacacacacacacacacacacacacacacacacadarasatatauauasasatavavawaxajaaaaaaaaaaaaaaaaaa
aaaaakaeafaeaeaeaeaeaeaeafayazazazaAahaiaiaiaiaiaiaiaiaiaiaiaiaiaiaiaiaiaiaiaiaiaiaiaiaiaiaiaiaiaiaiaiaiaiaiaiaiahaiaiaiaiaiaiaiaiaiaiaiaiaiaiaiaiaiaiaiaBaCaDawawawawawaEaFaGavavaHajaaaaaaaaaaaaaaaaaa
aaaaakaeafanananananananapaIaJaJaJaKaLaMaMaMaMaMaMaMaMaMaMaMaMaMaMaMaMaMaMaMaMaMaMaMaMaMaMaMaMaMaMaMaMaMaMaMaMaMahaiaiaiaiaiaiaiaiaiaiaiaiaiaiaiaiaiaiaiaBaNaOawawawawawawawawawawaPajaaaaaaaaaaaaaaaaaa
aaaaakanapaQaRaSaSagaTataJaUawaUaUaUataVayazaAaTataWaWaWaWaXaWaWaWaWaYatatatatatatatatatatatatatatatatatatatataZahaiaiaiaiaiaiaiaiaiaiaiaiaiaiaiaiaiaiaiaBaNawawawaEawawawawawawaFbaaqbbaaaaaaaaaaaaaaaa
aaaaakagbcagaTauatatawawawawbdbebdawawawatatatawawawawawawawawawawawawawawawbfawawawawbgbgbgbgbhbgbgbgbgawawawbaahaiaiaiaiaiaiaiaiaiaiaiaiaiaiaiaiaiaiaiaBaNawbdbdawawawawawawaFaFbaahajaaaaaaaaaaaaaaaa
aaaaakagagaTawawawawawawawawawbdbdawawawawawawawbibjbjbjbjbjbjbjbjbjbjbjbjbjbjbjbjbjbjbjbjbjbjbjbjbjbjbjbkawawbaaLaMaMaMblblaMaMblblaMaMaMaMaMaMaMaMaMaMbmaNawawbdbibjbjbjbjbjbjbjbnahajaaaaaaaaaaaaaaaa
aaaaakboagaNawawawawawawawawawawbdbdawawawawawawawawawawbdbdawawawawawawawawbpawawawbpbpawawawawawawawawawawawawatatasbqatatatbratbsatatasatatatatatatatatawbdawawawawawaUawbdbdbdbtahajaaaaaaaaaaaaaaaa
aaaaakaRboaNaOawawawbuawawawawawawawawavavavavawawbuawawawawawawawavavavavawawawbpawawawbdawawawavavavavawawawawawawbpaFbvawawbwbvawawaFawawawawawawawawawbdawawaUawawawawawawawbdbtahajaaaaaaaaaaaaaaaa
aaaaakagagaNawawawawawawawawawawawawbxavavavavawawawawawawawawawbxavavavavawawawawawawbdawawawbxavavavavawbyawawawawawbpawawaFaFawawaFawawbdawawawawawbubdbdawawawawawaUaUawawaUawbaahajaaaaaaaaaaaaaaaa
aaaaakagagaNawawawawawawawawawawawawawawawawawawbdbdawbdawawawawawawawawawawawawawbdawbdbdawbuawawawbpawawawawawawawawawbdawawawawawawawawawawawawawawbdbdawbdbdawawawaUawawawawawbtahajaaaaaaaaaaaaaaaa
aaaabzbAbAbAbBawbyawawawawawawawawawbdawawawawawawawawaUaUaUawawawawawawawawawbdawawawawawawawawawawawawawawawawawawawawawbdbdawawawawawawawawawawawawbdbdawawawbdawawawawawawaUawbaahajaaaaaaaaaaaaaaaa
aaaaaaaaaaaaakawawawbCawawawawawbDbAbAbAbAbAbAbAbAbAbAbAbAbAbAbAbAbAbAbAbAbAbAbAbAbAbAbAbAbAbAbAbBbDbAbAbAbAbAbAbAbAbAbBawawawawawawbdawawawawawawawawawawbdbdbeawbEawawawawawawawbaaLajaaaaaaaaaaaaaaaa
aaaaaaaaaaaaakawawawawawawawawawajaaaaaaaaaaaaaaaaaaaaaaaaaaaaaaaaaaaaaaaaaaaaaaaaaaaaaaaaaaaaaaakajaaaaaaaaaaaaaaaaaaakawawbdawaUawawawawawawawawawawawawawbdbdawawawawawawbdbdawawaVajaaaaaaaaaaaaaaaa
aaaaaaaaaaaaakbFawawawawawbDbAbAbGaaaaaaaaaaaaaaaaaaaaaaaaaaaaaaaaaaaaaaaaaaaaaaaaaaaaaaaaaaaaaaakajaaaaaaaaaaaaaaaaaaakbdbHbHbdawawawawawawawawawawawawawawawawawbdawawawbdawawawawbDbGaaaaaaaaaaaaaaaa
aaaaaaaaaaaaakaNbFawawawawajaaaaaaaaaaaaaaaaaaaaaaaaaaaaaaaaaaaaaaaaaaaaaaaaaaaaaaaaaaaaaaaaaaaaakajaaaaaaaaaaaaaaaaaaakbtagagbIbDbAbAbAbAbAbAbAbAbAbAbAbAbBawawawbdbJbdawawawbdbdawajaaaaaaaaaaaaaaaaaa
aaaaaaaaaaaaakaNawawawawawajaaaaaaaaaaaaaaaaaaaaaaaaaaaaaaaaaaaabKaaaabLaaaaaaaaaaaaaaaaaaaaaaaaakajaaaaaaaaaaaaaaaaaaakbMagagagajaaaaaaaaaaaaaaaaaaaaaaaaakawawbdbdbdawawawawbdbdawajaaaaaaaaaaaaaaaaaa
aaaaaaabacacadaNawawawawbaajaaaaaaaaaaaaaaaaaaaaaaaaaaaaaaabacacacacacacacacacacacacacacacacacacadaqacacacacacacacacacadagagagagajaaaaaaaaaabLaaaaaaaaaaaaakawawawawawawbdbdbubdawawajaaaaaaaaaaaaaaaaaa
aaaaaaakaeaeafaNawawawawbaaqacacbbaaaaaaaaaaaaaaaaaaaaaaaaakaiaiaiaiaiaiaiaiaiaiaiaiaiaiaiaiaiaiaBalaeaeaeaeaeaeaeaeaeafagbNagagajaaaaaaaaaaaaaaaaaaaaaaaaakawawawawbdawbdbdawbdawawajaaaaaaaaaaaaaaaaaa
aaaaaaakaeaeafaNawawawawbaahaiaiajaaaaaaaaaaaaaaaaaaaaaaaaakaiaiaiaiaiaiaiaiaiaiaiaiaiaiaiaiaiaiaBalaeaeaeaeaeaeaeaeaeafbNbNbNagaqacacacacacacacbbaaaaaaaaakbOawawbPbPawawbdawawawawajaaaaaaaaaaaaaaaaaa
aaaaaaakaeaeafbQbFawawawbaahaiaiajaaaaaaaaaaaaaaaaaaaaaaaaakaiaiaiaiaiaiaiaiaiaiaiaiaiaiaiaiaiaiaBalaeaeaeaeaeaeaeaeaeafbNbNbNaRalaeaeaeaeaeaeaeajaaaaaaaaakagawbaagagaNawawawawawbaajaaaaaaaaaaaaaaaaaa
aaaaaaakaeaeafbQbFbdaUbFbRahaiaiajaaaaaaaaaaaaaaaaaaaaaaaaakaMaMaMaMaMaMaMaMaMaMaMaMaMaMaMaMaMaMbmamanananananananananapbSbNbNbSamanananananananajaaaaaaaaakbTawbaagagaNawawawawawbtaqbbaaaaaaaaaaaaaaaa
aaaaaaakananapaNbdbdawbFbRaLaMaMajaaaaaaaaaaaaaaaaaaaaaaaaakbUbVbVbWatatatatatbWbWbWbWatatatatatatatatatatatbWatbXatatauatatatatbYatatbWatatbWaVajaaaaaaaaakaRawbMagagaNawawawawbdbaahajaaaaaaaaaaaaaaaa
aaaaaaakbUbVaJawbdawawawawatatbZajaabKaaaaaaaaaaaaaaaaaaaaakaNbpbpawcaawawawcbawawbdawawawccawawawawawcdawawawawawawawawawawawawawawawawaOawbdbtajaaaaaaaaakceagagagagaNawawawawawbaahajaaaaaaaaaaaaaaaa
acacacadaCawawawawaUaUawawaUawbaajaaaaaaaaaaaaaaaaaaaaaaaaakcfawawawawawawawawawawawawawawawawawcbawawawawcgawawawawbdbdawchawawawawawawawawawbaajaaaaaaaaakagagagagagaNawawawawawbaahajaaaaaaaaaaaaaaaa
aeaeaeafaNawawawawaUaUawbdbdbdbaaqacacacacacacacacacacacacadaNbdawawawavavavavawawawcbawawawawawawawawawawawawawbdbdbdcibdawbdawawawawawawawawbaaqacacacacadbTagagaTatawawawawawawbaahajaaaaaaaaaaaaaaaa
aeaeaeafcjawawbdbdbdawawawbdawbaahaiaiaiaiaiaiaiaiaiaiaiaiaBcfbdawawbxavavavavawawawawawawawawawawawawawawawcbawawbdbyawawbdawawawawawawawawawbaalaeaeaeaeafagagatbdbdawawawawawbdbaahajaaaaaaaaaaaaaaaa
aeaeaeafbIbPckclbHbPbPbPaUawbdbaahaiaiaiaiaiaiaiaiaiaiaiaiaBaNbdawawawawawawbdawbuawawawawawawcmawawawawawawawawawawawawbdbdawawbdawawawawawawbaamananananapbTagbdawawawawawawawbdbtahajaaaaaaaaaaaaaaaa
aeaeaeafaQagaSaSagagagagaNawawbaahaiaiaiaiaiaiaiaiaiaiaiaiaBaNawchawawawawbdbdawbdawawawawawawawawawawawawawawawbuawbdbdbdawawawawawawawawawawbaaRayazazaAaRagagawbdawawawawawbPbPbMahajaaaaaaaaaaaaaaaa
anananapbSbSbSbSbSbSbScncocpbjbnaLaMaMaMaMaMaMaMaMaMaMaMaMbmcqbkawawawbibjbjcrcscscscsctbjbjcrcscscscscscscscscscsctbjbjbjbjbjbjbjbjbkawawawawbaagcuaQagaSaSbTawawawawawawbdbacvbSbSaLajaaaaaaaaaaaaaaaa
agcwcwbNbNagagagagagagagawawawawagagagagagaRaRaRagagagagagagawawawawawawagagagagagagagagagagagaRaRagcuagagagagbNagagagagagagagagagagawawawawawawagagagagagawawawawawawawawawbMagayazaAajaaaaaaaaaaaaaaaa
cxcwcycwcybNczagczagczagawawawawczagczagczagczagczagczagczagcAcAcAcAcAcAczagczagczagczagczagczagczagczagczagczagczagczagczagczagczagcAcAcAcAcAcAczagczagczawcBawawawawawawbaagaQagaSaSajaaaaaaaaaaaaaaaa
awawawcCbFaUawbuawawawawawawawawawawawawawawawawawawawawbdawawawawawawawawawawawawawawawawawawawawawawawbdbdawawbFbFbFawawawawawawawawbyawawawawcDawawawawawawaUawbdawawawbaagagagagaRajaaaaaaaaaaaaaaaa
cEawawawawaUcFawawawawawawawawawawawawawawawbuawawavavavavawawawawawawawawawawawawawawawawbyawawawawawbdawawawawawawawawawawawawawbFawawawawawawcDawawbdawawawawawawawawawbaagagagagaRajaaaaaaaaaaaaaaaa
bFcGawawawaUawcFawawawawawawawawawawawawawawawawbdcHavavavawawawawawawawawawawawawawawawawawawawawawawawawawawawawawawawawawawawbFbFbFawawawawawcDawbdawaUawawawawawawaUawbaagagcIagagajaaaaaaaaaaaaaaaa
cCawcJcJcJcKaUawcFawawawawawawawawawawawawawawawbdbdbdawawawawawawawawawawawawawawawawawawawawawawawawawawawawawawawawawawawawawawbFawawawawawawcDawawawaUawawawaUawawawawbdaxagagagagajaaaaaaaaaaaaaaaa
cCawcLcLcLcLcMcLcLcLcLcLcLcLcLcLcLcLcLcLcLcLcLcLcLcLcLcLcLcLcLcLcLcLcLcLcLcLcLcLcLcLcLcLcLcLcLcLcLcLcLcLcLcLcLcLcLcLcLcLcLcLcLcLcLcLcLcLcLawawawcDawawawawawawaUawawawawbdawbaagagagagajaaaaaaaaaaaaaaaa
awcEawawawaUaUawawawawawawawawawawawawawawawawawawawawawawawbFbFawawawawawawawawawawawawawawawawawawawawawawawawawawawawawawawawawawawawawawawawcDawawawawawawawawawawawawawbMagagagbDbGaaaaaaaaaaaaaaaa
cNcCawawawaUaUawawawawawawawawawawawawawawawawawawawawawawawbFawawawawawawawawawawawawawawawawawawawawawawbuawawawawawbdawawawawbdawawawawawawawcDawbdawawcmawbuawawawawawbaagagagagajaaaaaaaaaaaaaaaaaa
awawawawawaUawawawawbuawawawawawawawawawawawawawawawawawawawawawawawawawawbyawawawawawawawawawawawawawawawawawawawawbdavavavavawbdawawawawawawawcDawawawawaUawawawawawaUawbMagagagagajaaaaaaaaaaaaaaaaaa
cEawawawawaUawawawawawawawawbyawawawawawawawawawawawawawawawawawawawawawawawawawawawawawawawawawawawawawawawawawbFbFawcOavavavbdawawawawawawawawcDawawawawawawawawbdawawbMaQagaSaSagajaaaaaaaaaaaaaaaaaa
bNbNcPagagagagagagagagagagagagagagagagagagagagagagagagagagagagagagagagagagagagagagagagagagagagagagagagagagagagagbNbNagagagagagagagagagagagagagagagawawawawawawawawawawawawagagagagagajaaaaaaaaaaaaaaaaaa
cQcwcRcwcRbNcScTcUcTcUcTcUcTcUcTcUcTcUcTcUcTcUcTcUcTcUcTcUcTcUcTcUcTcUcTcUcTcUcTcUcTcUcTcUcTcUcTcUcTcUcTcUagcSagcSagcSagcSagcSagcSagcScTcUcTcUcTcUaUcVaUcVaUcVaUcVaUcVaUcVcTcUagcSagajaaaaaaaaaaaaaaaaaa
"}
